丁	一 亅
丂	一 乙
七	一 乚	丿 乚
丄	丨 一
丅	一 丨
万	一 勹	一 刀
丈	一 乂
三	一 二	一 一 一
上	一 丨 一	丶 丨 一
下	一 卜	一 丨 丶
丌	一 丿 丨
不	一 丿 丨 丶
丐	下 勹	正 丿
丑	㇆ 一 丨 一
丒	刃 一
且	月 一
丕	不 一
世	廿 丨 一
丗	廿 丨	十 凵
丘	厂 工	厂 丅 一
丙	一 人 冂
丞	氶 一
丟	三 厶
丠	北 一
両	一 山 冂
並	丷 亚	丷 一 业
丫	丶 丶 丨
丬	冫 丨
中	口 丨
丮	乁 二 丨
丯	丨 彡
丰	丿 二 丨	三 丨
串	口 口 丨	中 口
丳	串 丿
丵	业 丷 干
丷	丶 丿
丸	丶 九
丹	冂 丶 一
主	丶 王
丼	井 丶
乂	乀 丿
乃	丿 ㇆ ㇆
久	丿 入
乆	𠃊 人
乇	丿 七
么	丿 厶
乍	丿 丅 二
乎	丿 丷 一 亅
乏	丿 之
乑	丿 丨 丿 丿 丶 乀
乒	丘 丿
乓	丘 丶
乕	厂 一 巿	厂 二 巾
乖	千 北
乗	禾 艹 一
乘	禾 北	禾 丬 匕
乜	卩 乚
九	丿 乙
乞	丿 一 乙
也	卩 丨 乚
乢	山 乙	山 乚
乣	幺 乙	幺 乚
乨	台 乙	台 乚
乩	占 乙	占 乚
乪	乙 田
乫	加 乙
乭	石 乙
乳	孚 乙	孚 乚
乴	折 乙
乵	辛 乙	辛 乚
乶	甫 乙
乷	沙 乙
乸	也 母
乹	十 日 十 乚
乾	十 日 十 乞
乿	爪 糸 乙	爫 糸 乚
亀	龟 日	龟 曰	刀 日 电
亁	十 日 干 乞
亂	爪 龴 冂 厶 又 乙	爫 龴 冂 厶 又 乚
亃	粦 乙	粦 乚
亄	壹 乙	壹 乚
了	乛 亅
予	龴 乛 亅
亊	一 丷 亅 聿	一 丷 亅 肀
事	一 口 聿	一 口 肀
二	一 一
亍	一 丁
于	二 亅
亐	一 丂
云	二 厶
互	一 彑
亓	一 丌
五	二 丨 ㇆
井	二 丿 丨
亖	二 二
亗	山 二
亙	万 丶 丶 一	二 彑 丶
些	此 二
亜	二 口 丨 丨
亝	厽 二
亞	二 □
亟	丂 口 又 一
亠	丶 一
亡	丶 匸
亢	亠 几
亣	丶 丌
交	亠 父
亥	亠 □ 人
亦	亠 丿 亅 八
亨	亠 口 了
享	亠 口 子
京	亠 口 小
亭	亠 口 冖 丁
亮	亠 口 冖 儿
亯	亠 口 日
亰	亠 日 小
亱	亠 但
亳	亠 口 冂 乇
亴	亠 口 冂 土 九
亶	亠 回 旦
亷	亠 兼 丿
亹	亠 舋
人	丿 乀
亻	丿 丨
亼	人 一
亾	丨 一 人
什	人 十	亻 十
仁	人 二	亻 二
仂	人 力	亻 力
仃	人 丁	亻 丁
仄	厂 人
仆	人 卜	亻 卜
仇	人 九	亻 九
仈	人 八	亻 八
仉	人 几	亻 几
今	人 丶 乛
介	人 丿 丨
仌	人 人
仍	人 乃	亻 乃
仏	人 厶	亻 厶
仐	人 十
仒	人 冰	人 冫	人 丶 丶
仔	人 子	亻 子
仕	人 士	亻 士
他	人 也	亻 也
仗	人 丈	亻 丈
付	人 寸	亻 寸
仙	人 山	亻 山
仚	人 山
仛	人 乇	亻 乇
仜	人 工	亻 工
仝	人 工
仞	人 刃	亻 刃
仟	人 千	亻 千
仠	人 干	亻 干
仡	人 乞	亻 乞
仢	人 勺	亻 勺
代	人 弋	亻 弋
令	人 一 卩
以	□ 丶 人
仦	人 小	亻 小
仧	上 人
仨	人 三	亻 三
仫	人 么	亻 么
仭	人 刄	亻 刄
仮	人 反	亻 反
仯	人 少	亻 少
仰	人 卬	亻 卬
仱	人 今	亻 今
仲	人 中	亻 中
仳	人 比	亻 比
仴	人 月	亻 月
仵	人 午	亻 午
件	人 牛	亻 牛
仸	人 夭	亻 夭
仹	人 丰	亻 丰
仺	人 匚 一
任	人 壬	亻 壬
仼	人 王	亻 王
份	人 分	亻 分
仾	人 互	亻 互
仿	人 方	亻 方
伀	人 公	亻 公
企	人 止
伂	人 巿	亻 巿
伃	人 予	亻 予
伄	人 弔	亻 弔
伅	人 屯	亻 屯
伆	人 勿	亻 勿
伇	人 殳	亻 殳
伈	人 心	亻 心
伉	人 亢	亻 亢
伊	人 尹	亻 尹
伋	人 及	亻 及
伌	人 厄	亻 厄
伍	人 五	亻 五
伎	人 支	亻 支
伏	人 犬	亻 犬
伐	人 戈	亻 戈
休	人 木	亻 木
伒	人 斤	亻 斤
伓	人 不	亻 不
伔	人 冗	亻 冗
伕	人 夫	亻 夫
伖	人 友	亻 友
伙	人 火	亻 火
伜	人 卆	亻 卆
伢	人 牙	亻 牙
伨	人 勻	亻 勻
伩	人 文	亻 文
伭	人 玄	亻 玄
伮	人 奴	亻 奴
伯	人 白	亻 白
估	人 古	亻 古
伱	人 尒	亻 尒
伲	人 尼	亻 尼
伳	人 世	亻 世
伴	人 半
伵	人 四	亻 四
伶	人 令	亻 令
伷	人 由	亻 由
伸	人 申	亻 申
伹	人 且	亻 且
伺	人 司	亻 司
伻	人 平	亻 平
似	人 以	亻 以
伽	人 加	亻 加
伾	人 丕	亻 丕
伿	人 只	亻 只
佀	人 尸 乛 一	亻 尸 乛 一
佁	人 台	亻 台
佂	人 正	亻 正
佃	人 田	亻 田
佄	人 甘	亻 甘
佅	人 未	亻 未
但	人 旦	亻 旦
佇	人 宁	亻 宁
佈	人 布	亻 布
佉	人 去	亻 去
佊	人 皮	亻 皮
佋	人 召	亻 召
佌	人 此	亻 此
位	人 立	亻 立
低	人 氐	亻 氐
住	人 主	亻 主
佐	人 左	亻 左
佑	人 右	亻 右
佒	人 央	亻 央
佔	人 占	亻 占
何	人 可	亻 可
佖	人 必	亻 必
佗	人 它	亻 它
佘	人 示
余	人 于 八
佚	人 失	亻 失
佛	人 弗	亻 弗
作	人 乍	亻 乍
佝	人 句	亻 句
佞	人 二 女	亻 二 女
佟	人 冬	亻 冬
你	人 尔	亻 尔
佡	人 仚	亻 仚
佢	人 巨	亻 巨
佣	人 用	亻 用
佤	人 瓦	亻 瓦
佧	人 卡	亻 卡
佩	人 几 帀	亻 几 帀
佪	人 回	亻 回
佫	人 各	亻 各
佬	人 老	亻 老
佭	人 夅	亻 夅
佮	人 合	亻 合
佯	人 羊	亻 羊
佰	人 百	亻 百
佱	人 一 正	亻 一 正
佲	人 名	亻 名
佳	人 圭	亻 圭	人 土 土	亻 土 土
佴	人 耳	亻 耳
併	人 并	亻 并	人 幷	亻 幷
佶	人 吉	亻 吉
佷	人 艮	亻 艮
佸	人 舌	亻 舌
佹	人 危	亻 危
佺	人 全	亻 全
佻	人 兆	亻 兆
佼	人 交	亻 交
佽	人 次	亻 次
佾	人 八 月	亻 八 月	人 八 肉	亻 八 肉
使	人 吏	亻 吏
侀	人 刑	亻 刑
侁	人 先	亻 先
侂	人 广 乇	亻 广 乇
侃	人 口 川	亻 口 川
侄	人 至	亻 至
侅	人 亥	亻 亥
來	木 人 人	一 人 人 丨 人
侇	人 夷	亻 夷
侈	人 多	亻 多
侉	人 夸	亻 夸
侊	人 光	亻 光
例	人 列	亻 列
侌	今 云
侍	人 寺	亻 寺
侎	人 米	亻 米
侏	人 朱	亻 朱
侐	人 血	亻 血
侑	人 有	亻 有
侒	人 安	亻 安
侓	人 聿	亻 聿
侔	人 牟	亻 牟
侕	人 而	亻 而
侖	人 一 冊
侗	人 同	亻 同
侘	人 宅	亻 宅
侙	人 式	亻 式
侚	人 旬	亻 旬
供	人 共	亻 共
侜	人 舟	亻 舟
依	人 衣	亻 衣
侞	人 如	亻 如
侟	人 存	亻 存
価	人 西	亻 西
侢	人 再	亻 再
侫	人 忘	亻 忘
侭	人 尽	亻 尽
侮	人 每	亻 每
侯	人 乛 一 矢	亻 乛 一 矢
侰	人 君	亻 君
侱	人 呈	亻 呈
侲	人 辰	亻 辰
侳	人 坐	亻 坐
侴	人 一 丑 刀	人 一 丑 刂
侵	人 彐 冖 又	亻 彐 冖 又
侶	人 呂	亻 呂
侷	人 局	亻 局
侸	人 豆	亻 豆
侹	人 廷	亻 廷
侺	人 岑	亻 岑
侻	人 兌	亻 兌
侼	人 孛	亻 孛
侽	人 男	亻 男
侾	人 孝	亻 孝
便	人 更	亻 更
俀	人 妥	亻 妥
俁	人 吳	亻 吳
係	人 系	亻 系
促	人 足	亻 足
俄	人 我	亻 我
俅	人 求	亻 求
俆	人 余	亻 余
俇	人 狂	亻 狂
俈	人 告	亻 告
俉	人 吾	亻 吾
俊	人 夋	亻 夋
俋	人 邑	亻 邑
俌	人 甫	亻 甫
俍	人 良	亻 良
俎	人 人 且	仌 且
俏	人 肖	亻 肖
俐	人 利	亻 利
俑	人 甬	亻 甬
俒	人 完	亻 完
俓	人 巠	亻 巠
俔	人 見	亻 見
俕	人 宋	亻 宋
俖	人 否	亻 否
俗	人 谷	亻 谷
俘	人 孚	亻 孚
俙	人 希	亻 希
俚	人 里	亻 里
俛	人 免	亻 免
俜	人 甹	亻 甹
保	人 呆	亻 呆
俞	人 一 月 刀	人 一 月 刂
俟	人 矣	亻 矣
俠	人 夾	亻 夾
信	人 言	亻 言
俢	人 夕 彡	亻 夂 彡
俤	人 弟	亻 弟
俥	人 車	亻 車
修	攸 彡
俯	人 府	亻 府
俰	人 和	亻 和
俱	人 具	亻 具
俲	人 効	亻 効
俳	人 非	亻 非
俴	人 戔	亻 戔
俵	人 表	亻 表
俶	人 叔	亻 叔
俷	人 肥	亻 肥
俸	人 奉	亻 奉
俹	人 亞	亻 亞
俺	人 奄
俻	人 备	亻 备
俼	人 育	亻 育
俽	人 欣	亻 欣
俾	人 卑	亻 卑
俿	人 虎	亻 虎
倀	人 長	亻 長
倁	人 知	亻 知
倂	人 幷	亻 幷
倃	人 咎	亻 咎
倄	人 肴	亻 肴
倅	人 卒	亻 卒
倆	人 兩	亻 兩
倇	人 宛	亻 宛
倈	人 來	亻 來
倉	人 尸 一 口
倊	人 忩	亻 忩
個	人 固	亻 固
倌	人 官	亻 官
倍	人 咅	亻 咅	人 立 口	亻 立 口
倎	人 典	亻 典
倏	攸 犬
倐	攸 火
們	人 門	亻 門
倒	人 到	亻 到
倓	人 炎	亻 炎
倔	人 屈	亻 屈
倕	人 垂	亻 垂
倖	人 幸	亻 幸
倗	人 朋	亻 朋
倘	人 尚	亻 尚
候	人 丨 乛 一 矢	亻 丨 乛 一 矢	侯 丨
倚	人 奇	亻 奇
倛	人 其	亻 其
倜	人 周	亻 周
倝	十 日 十 人
倞	人 京	亻 京
借	人 昔	亻 昔
倠	人 隹	亻 隹
倡	人 昌	亻 昌
倢	人 疌	亻 疌
倣	人 放	亻 放
値	人 直	亻 直
倥	人 空	亻 空
倦	人 卷	亻 卷
倧	人 宗	亻 宗
倨	人 居	亻 居
倩	人 青	亻 青
倪	人 兒	亻 兒
倫	人 侖	亻 侖
倬	人 卓	亻 卓
倭	人 委	亻 委
倮	人 果	亻 果
倯	人 松	亻 松
倰	人 夌	亻 夌
倱	人 昆	亻 昆
倲	人 東	亻 東
倳	人 事	亻 事
倴	人 奔	亻 奔
倵	人 武	亻 武
倶	人 具	亻 具
倷	人 奈	亻 奈
倸	人 采	亻 采
倹	人 人 一 口 人	亻 人 一 口 人
倻	人 耶	亻 耶
值	人 直	亻 直
倽	人 舍	亻 舍
偀	人 英	亻 英
偁	人 爯	亻 爯
偂	人 前	亻 前
偃	人 匽	亻 匽	人 匚 妟	亻 匚 妟	人 匚 日 女	亻 匚 日 女
偄	人 耎	亻 耎
偅	人 重	亻 重
偆	人 春	亻 春
假	人 叚	亻 叚
偈	人 曷	亻 曷
偉	人 韋	亻 韋
偊	人 禹	亻 禹
偋	人 屏	亻 屏
偌	人 若	亻 若
偍	人 是	亻 是
偎	人 畏	亻 畏
偏	人 扁	亻 扁
偐	人 彦	亻 彦
偑	人 風	亻 風
偒	人 易	亻 易
偓	人 屋	亻 屋
偔	人 咢	亻 咢
偕	人 皆	亻 皆
偖	人 者	亻 者
偗	人 省	亻 省
偘	人 品	亻 品
偙	人 帝	亻 帝
做	人 故	亻 故
偛	人 臿	亻 臿
停	人 亭	亻 亭
偝	人 背	亻 背
偞	人 枼	亻 枼
偟	人 皇	亻 皇
偠	人 要	亻 要
偡	人 甚	亻 甚
偢	人 秋	亻 秋
偣	人 音	亻 音
偤	人 酋	亻 酋
健	人 建	亻 建
偦	人 女 疋	亻 女 疋
偧	人 大 多	亻 大 多	人 奓	亻 奓
偨	人 奓	亻 奓
偩	人 負	亻 負
偪	人 畐	亻 畐
偫	人 待	亻 待
偬	人 怱	亻 怱
偭	人 面	亻 面
偮	人 咠	亻 咠
偯	人 哀	亻 哀
偰	人 契	亻 契
偱	人 盾	亻 盾
偲	人 思	亻 思
偳	人 耑	亻 耑
側	人 則	亻 則
偵	人 貞	亻 貞
偶	人 禺	亻 禺
偷	人 俞	亻 俞
偸	人 兪	亻 兪
偹	攸 田	人 丨 备	亻 丨 备
偺	人 昝	亻 昝
偼	人 疌	亻 疌
偽	人 為	亻 為
傀	人 鬼	亻 鬼
傁	人 叟	亻 叟
傂	人 虒	亻 虒
傃	人 素	亻 素
傄	人 眘	亻 眘
傅	人 甫 寸	亻 甫 寸	亻 尃
傆	人 原	亻 原
傇	人 茸	亻 茸
傈	人 栗	亻 栗
傉	人 辱	亻 辱
傊	人 員	亻 員
傋	人 冓	亻 冓
傌	人 馬	亻 馬
傍	人 旁
傎	人 真	亻 真
傏	人 唐	亻 唐
傐	人 高	亻 高
傑	人 桀	亻 桀
傒	人 奚	亻 奚
傓	人 扇	亻 扇
傔	人 丶 丶 兼	亻 丶 丶 兼
傕	人 隺	亻 隺
傖	人 倉	亻 倉
傗	人 畜	亻 畜
傘	人 人 人 人 十
備	人 草 厂 用	亻 艹 厂 用	亻 井 厂 用
傚	人 交 攴	人 交 攵	亻 交 攵
傛	人 容	亻 容
傜	人 月 缶	亻 月 缶	人 䍃	亻 䍃
傝	人 日 羽	亻 日 羽
傞	人 差	亻 差
傟	人 翁	亻 翁
傠	人 討	亻 討
傡	人 竝	亻 竝
傢	人 家	亻 家
傣	人 泰	亻 泰
傪	人 參	亻 參
傫	人 累	亻 累
催	人 崔	亻 崔
傭	人 庸	亻 庸
傮	人 曹	亻 曹
傯	人 悤	亻 悤
傰	人 崩	亻 崩
傱	人 從	亻 從
傲	人 敖
傳	人 專	亻 專
傴	人 區	亻 區
債	人 責	亻 責
傶	人 戚	亻 戚
傷	人 丿 一 昜	亻 丿 一 昜	人 丿 一 日 一 勿
傸	人 爽	亻 爽
傹	人 竟	亻 竟
傺	人 祭	亻 祭
傻	人 囟 儿 夕	亻 囟 儿 夂
傼	人 革 大	亻 革 大
傽	人 章	亻 章
傾	人 頃	亻 頃
傿	人 焉	亻 焉
僀	人 帶	亻 帶
僁	人 悉	亻 悉
僂	人 婁	亻 婁
僃	人 草 勹 用	人 艸 勹 用	亻 艹 勹 用
僄	人 票	亻 票
僅	人 堇	亻 堇
僆	人 連	亻 連
僇	人 翏	亻 翏
僈	人 曼	亻 曼
僉	人 一 口 口 人 人
僊	人 西 大 己	亻 覀 大 己
僋	人 貪	亻 貪
僌	人 車 攴	亻 車 攵
働	人 動	亻 動
僎	人 巽	亻 巽
像	人 象	亻 象
僐	人 善	亻 善
僑	人 喬	亻 喬
僒	人 窘	亻 窘
僓	人 貴	亻 貴
僔	人 尊	亻 尊
僕	人 菐	亻 菐
僖	人 喜	亻 喜
僗	人 勞	亻 勞
僘	人 敞	亻 敞
僙	人 黃	亻 黃	人 黄	亻 黄
僚	人 尞	亻 尞
僛	人 欺	亻 欺
僜	人 登	亻 登
僝	人 孱	亻 孱
僞	人 爲	亻 爲
僟	人 幾	亻 幾
僠	人 番	亻 番
僡	人 惠	亻 惠
僢	人 舜	亻 舜
僣	人 替	亻 替
僤	人 單	亻 單
僥	人 堯	亻 堯
僦	人 就	亻 就
僧	人 曽	亻 曽	人 曾	亻 曾
僨	人 賁	亻 賁
僩	人 閒	亻 閒
僪	人 矞	亻 矞
僫	人 惡	亻 惡
僬	人 焦	亻 焦
僭	人 朁	亻 朁
僮	人 童	亻 童
僯	人 粦	亻 粦
僰	棘 人
僱	人 雇	亻 雇
僳	人 粟	亻 粟
僴	人 間	亻 間
僵	人 畺	亻 畺
僶	人 黽	亻 黽
僷	人 葉	亻 葉
僸	人 禁	亻 禁
價	人 賈	亻 賈
僺	人 喿	亻 喿
僻	人 辟	亻 辟
僼	人 豐	亻 豐
僽	人 愁	亻 愁
僾	人 愛	亻 愛
僿	人 塞	亻 塞
儀	人 義	亻 義
儁	人 雋	亻 雋
儂	人 農	亻 農
儃	人 亶	亻 亶
億	人 意	亻 意
儅	人 當	亻 當
儆	人 敬	亻 敬
儇	人 睘	亻 睘
儈	人 會	亻 會
儉	人 僉	亻 僉
儊	人 楚	亻 楚
儋	人 詹	亻 詹
儌	人 敫	亻 敫
儍	人 凶 丶 丶 丶 丶 八 夕	亻 凶 丶 丶 丶 丶 八 夂
儎	人 載	亻 載
儐	人 賓	亻 賓
儑	人 日 幺 幺 火	亻 日 幺 幺 灬	人 㬎	亻 㬎
儒	人 需	亻 需
儓	人 臺	亻 臺
儔	人 壽	亻 壽
儕	人 齊	亻 齊
儖	人 監	亻 監
儗	人 疑	亻 疑
儘	人 盡	亻 盡
儙	人 遣	亻 遣
儚	人 夢	亻 夢
儛	人 舞	亻 舞
儜	人 寧	亻 寧
儝	人 榮	亻 榮
儞	人 爾	亻 爾
償	人 賞	亻 賞
儠	人 巤	亻 巤
儡	人 畾	亻 畾	人 田 田 田	亻 田 田 田
儢	人 慮	亻 慮
儣	人 廣	亻 廣
儤	人 暴	亻 暴
儥	人 賣	亻 賣
儦	人 麃	亻 麃
儧	人 賛	亻 賛
儨	人 質	亻 質
儩	人 賜	亻 賜
優	人 憂	亻 憂
儫	人 豪	亻 豪
儬	人 靚	亻 靚
儭	人 親	亻 親
儮	人 歷	亻 歷
儯	人 駦	亻 駦
儰	人 蒍	亻 蒍
儱	人 龍	亻 龍
儲	人 諸	亻 諸
儳	人 毚	亻 毚
儴	人 襄	亻 襄
儵	攸 黑	攸 黑
儶	人 巂	亻 巂
儷	人 麗	亻 麗
儸	人 羅	亻 羅
儹	人 贊	亻 贊
儺	人 難	亻 難
儻	人 黨	亻 黨
儼	人 嚴	亻 嚴
儽	人 纍	亻 纍
儾	人 囊	亻 囊
兀	一 儿
允	厶 儿
兂	匸 丿 乚 旡	厂 尢 旡
元	二 儿
兄	口 儿
充	亠 允
兆	儿 丷 八	冰 儿 丶 丶	冫 儿 丶 丶
兇	凶 儿
先	丿 土 儿
光	小 兀
兊	公 儿	八 允
克	十 兄	十 口 儿
兌	八 兄	八 口 儿
免	刀 口 丨 儿
兎	丿 丨 口 儿 丶
兏	厂 上 儿
児	旧 儿
兒	臼 儿
兓	旡 旡
兔	刀 口 丨 儿 丶
兕	凹 儿
兖	亠 兊
兗	亠 兌
兘	元 台
兛	克 千
兜	匚 白 ㇆ 一 儿
兝	克 分
兞	克 毛
兟	先 先
兠	北 白 儿	丬 白 匕 儿
兢	克 克
兣	克 厘
兤	光 廣
入	乁 丿
兦	丨 一 入
內	冂 入
全	人 王
兩	一 冂 丨 入 入
兪	入 一 肉 巜	入 一 月 巜
八	丿 乁
公	八 厶
六	亠 八
兮	八 丂
共	井 八	十 丨 一 八	二 丨 丨 八
兲	王 八
兵	丘 八
其	甘 一 八
具	目 一 八
典	曲 八
兼	丷 一 彐 丨 丨 八	丷 一 聿 丨 丨 八	丷 一 肀 丨 丨 八
兾	丷 異
兿	丷 一 执 云
冀	北 異
冂	丨 乙
冄	冂 二
円	冂 丄
冇	一 丿 冂
冉	冂 十 一
冊	冂 一 丨 丨
冋	冂 口
再	一 冂 十 一
冏	冂 八 口
冐	冂 二 月	曰 月	日 月
冑	由 冃	由 冂 二	由 月
冒	冃 目	冂 二 目	曰 目	日 目
冓	井 再
冔	冃 吁	冂 二 吁
冕	冃 勉	冂 二 勉	曰 勉	日 勉
冖	丶 乛
冗	冖 几
冘	冖 人	冖 丿 乚
冚	冖 山
冝	冖 且
冞	冖 米
冟	冖 皀	冖 皂
冠	冖 元 寸
冡	冖 一 豕
冢	冖 豖
冣	冖 取
冤	冖 兔
冥	冖 日 大
冦	冖 元 攴
冧	冖 林
冨	冖 畐
冩	冖 舄
冪	冖 幕
冫	丶 丿
冬	夕 冰	夂 冫
冭	大 冰	大 冫
冮	冰 工	冫 工
冰	冰 水	冫 水
冱	冰 互	冫 互
冴	冰 牙	冫 牙
冶	冰 台	冫 台
冷	冰 令	冫 令
冸	冰 半	冫 半
冹	冰 犮	冫 犮
冺	冰 民	冫 民
冼	冰 先	冫 先
冽	冰 列	冫 列
冾	冰 合	冫 合
冿	冰 聿	冫 聿
凁	冰 束	冫 束
凂	冰 免	冫 免
凃	冰 余	冫 余
凅	冰 固	冫 固
准	冰 隹	冫 隹
凇	冰 松	冫 松
凈	冰 爭	冫 爭
凊	冰 青	冫 青
凋	冰 周	冫 周
凌	冰 夌	冫 夌
凍	冰 東	冫 東
凎	冰 金	冫 金
凐	冫 垔	冰 垔
凒	冰 豈	冫 豈
凓	冰 栗	冫 栗
凔	冰 倉	冫 倉
凕	冰 冥	冫 冥
凗	冰 崔	冫 崔
凘	冰 斯	冫 斯
凙	冰 睪	冫 睪
凚	冰 禁	冫 禁
凜	冰 稟	冫 稟
凝	冰 疑	冫 疑
凞	冰 熙	冫 熙
凟	冰 賣	冫 賣
几	丿 乙
凡	几 丶
凢	丶 几
凣	丨 几	丶 几
凥	尸 几
処	夕 几	夂 几
凧	几 巾
凨	几 云
凬	几 一 日
凮	几 百
凰	几 皇
凱	豈 几
凲	几 兼
凳	登 几
凴	馮 几
凵	丨 一 丨
凶	凵 乂
凷	凵 土
出	山 山	山 凵	凵 丨 凵
凼	凵 水
函	凵 氶
凾	凵 了 口 又	凵 亟
刀	㇆ 丿
刂	丨 亅
刃	刀 丶
刄	刀 乀
刅	刀 八
分	八 刀
切	七 刀
刈	乂 刀	乂 刂
刉	乞 刀	乞 刂
刊	干 刀	干 刂
刋	千 刀	千 刂
刌	寸 刀	寸 刂
刍	刀 彐
刎	勿 刀	勿 刂
刏	气 刀	气 刂
刐	丹 刀	丹 刂
刑	开 刀	开 刂
划	戈 刀	戈 刂
刓	元 刀	元 刂
刔	夬 刀	夬 刂
刕	刀 刀 刀
刖	月 刀	月 刂
列	歹 刀	歹 刂
刜	弗 刀	弗 刂
初	衣 刀	衤 刀
刞	且 刀	且 刂
刟	召 刀	召 刂
刡	民 刀	民 刂
刢	令 刀	令 刂
刣	台 刀	台 刂
判	半 刀	半 刂
別	口 刀 刀	口 刀 刀 刂
刦	去 刀	去 刂
刧	去 刀
刨	包 刀	包 刂
利	禾 刀	禾 刂
刪	冊 刀	冊 刂
刮	舌 刀	舌 刂
刯	亘 刀	亘 刂
到	至 刀	至 刂
刱	井 刅
刲	圭 刀	圭 刂
刳	夸 刀	夸 刂
刴	朶 刀	朶 刂
刵	耳 刀	耳 刂
制	丿 二 巾 刀	丿 二 巾 刂
刷	尸 巾 刀	尸 巾 刂
券	丷 夫 刀	𠔉 刀
刺	朿 刀	朿 刂	木 冂 刀	木 冂 刂
刻	亥 刀	亥 刂
刼	去 刃
剁	朵 刀	朵 刂
剃	弟 刀	弟 刂
剄	巠 刀	巠 刂
剅	豆 刀	豆 刂
剆	艮 刀	艮 刂
則	貝 刀	貝 刂
剈	肙 刀	肙 刂
剉	坐 刀	坐 刂
削	肖 刀	肖 刂
剋	克 刀	克 刂
剌	束 刀	束 刂
前	丷 一 肉 刀	丷 一 月 刂
剎	乂 丶 木 刀	乂 丶 木 刂
剏	并 刃
剒	昔 刀	昔 刂
剓	禾 勹 丿 刀
剔	易 刀	易 刂
剕	非 刀	非 刂
剖	咅 刀	咅 刂	立 口 刀	立 口 刂
剗	戔 刀	戔 刂
剘	其 刀	其 刂
剙	并 刅
剚	事 刀	事 刂
剛	岡 刀	岡 刂
剜	宛 刀	宛 刂
剝	彔 刀	彔 刂
剞	奇 刀	奇 刂
剟	叕 刀	叕 刂
剠	京 刀	京 刂
剡	炎 刀	炎 刂
剢	豖 刀	豖 刂
剣	人 一 口 人 刀	人 一 口 人 刂
剤	斉 刀	斉 刂
剦	奄 刀	奄 刂
剨	砉 刀	砉 刂
剩	乘 刀	乘 刂
剪	前 刀
剫	度 刀	度 刂
剬	耑 刀	耑 刂
剭	屋 刀	屋 刂
剮	咼 刀	咼 刂
副	畐 刀	畐 刂
剰	乗 刀	乗 刂
剱	人 一 口 人 刄
割	害 刀	害 刂
剳	荅 刀	荅 刂
剴	豈 刀	豈 刂
創	倉 刀	倉 刂
剶	彖 刀	彖 刂
剸	專 刀	專 刂
剹	翏 刀	翏 刂
剺	未 攵 厂 刀
剻	崩 刀	崩 刂
剼	參 刀	參 刂
剽	票 刀	票 刂
剾	區 刀	區 刂
剿	巢 刀	巢 刂
劀	矞 刀	矞 刂
劁	焦 刀	焦 刂
劂	厥 刀	厥 刂
劃	畫 刀	畫 刂
劄	答 刀	答 刂
劅	蜀 刀	蜀 刂
劆	廉 刀	廉 刂
劇	豦 刀	豦 刂
劈	辟 刀
劉	卯 金 刀	卯 金 刂
劊	會 刀	會 刂
劋	喿 刀	喿 刂
劌	歲 刀	歲 刂
劍	僉 刀	僉 刂
劎	僉 刀
劏	當 刀	當 刂
劐	蒦 刀	蒦 刂
劑	齊 刀	齊 刂
劒	僉 刃
劓	鼻 刀	鼻 刂
劔	僉 刄
劕	質 刀	質 刂
劖	毚 刀	毚 刂
劗	贊 刀	贊 刂
劘	靡 刀	靡 刂
劙	蠡 刀	蠡 刂
劚	屬 刀	屬 刂
力	丿 ㇆
劜	力 乚
功	工 力
加	力 口
劣	少 力
劤	斤 力
劥	亢 力
劦	力 力 力
劧	手 力
助	且 力
努	奴 力
劫	去 力
劬	句 力
劭	召 力
劮	失 力
劯	石 力
劰	白 力
労	小 冖 力
劵	丷 夫 力	𠔉 力
劶	后 力
劷	羊 力
劸	圭 力
効	交 力
劺	牟 力
劻	匡 力
劼	吉 力
劽	列 力
劾	亥 力
勀	克 力
勁	巠 力
勂	告 力
勃	孛 力
勄	每 力
勅	束 力
勆	良 力
勇	甬 力
勈	甬 力
勉	免 力
勊	克 力
勌	卷 力
勍	京 力
勎	坴 力
勏	咅 力
勐	孟 力
勑	來 力
勒	革 力
勓	皆 力
勔	面 力
動	重 力
勖	冒 力
勗	日 助
勘	甚 力
務	矛 务	矛 夂 力
勛	員 力
勜	翁 力
勝	肉 劵	月 劵	月 丷 夫 力
勞	𤇾 力	𤇾 力
募	莫 力
勠	翏 力
勡	票 力
勢	埶 力	執 力
勣	責 力
勤	堇 力
勥	強 力
勦	巢 力
勧	丿 二 隹 力
勨	象 力
勩	貰 力
勪	喬 力
勫	番 力
勬	絭 力
勭	童 力
勮	豦 力
勯	亶 力
勰	劦 思
勱	萬 力
勲	動 火	動 灬
勳	熏 力
勴	慮 力
勵	厲 力
勶	徹 力
勷	襄 力
勸	雚 力
勹	丿 ㇆
勺	勹 丶
勻	勹 二
勼	勹 九
勽	勹 人
勾	勹 厶
勿	勹 丿 丿
匃	勹 亾
匄	勹 亡
包	勹 己
匆	勿 丶
匈	勹 凶
匉	勹 平
匊	勹 米
匋	勹 缶
匌	勹 合
匍	勹 甫
匎	勹 奄
匏	夸 包
匐	勹 畐
匑	勹 躬
匒	勹 荅
匓	勹 艮 殳
匔	勹 身 吕
匕	乚 丿
化	人 匕	亻 匕
北	丬 匕
匘	匕 巛 囟	匕 𡿺
匙	是 匕
匛	匚 久
匜	匚 也
匝	匚 巾
匞	匚 工
匟	匚 亢
匠	匚 斤
匡	匚 王
匢	匚 勿
匣	匚 甲
匤	匚 玉
匥	匚 弁
匧	匚 夾
匨	匚 壯
匩	匚 山 王	匡 山
匪	匚 非
匫	匚 曶
匬	匚 俞
匭	匚 軌
匯	匚 淮
匰	匚 單
匱	匚 貴
匲	匚 大 品
匳	匚 僉
匴	匚 算
匵	匚 賣
匶	匚 舊
匷	匚 瞿
匹	匸 儿	匚 儿
匼	匸 合
匽	匸 妟
匾	匸 扁	匚 扁
匿	匸 若	匚 若
區	匸 品	匚 品
十	一 丨
卂	乁 十
千	丿 十
卄	十 丨	一 丨 丨
卅	川 一
卆	九 十
升	千 丨	丿 十 丿
午	丿 干
卉	十 廾
半	丷 一 十	八 一 十
卋	十 廿
卌	丿 丨 丨 丨 丨 一	川 丨 一
卑	丶 田 丿 十
卒	亠 人 十
卓	卜 日 十
協	十 劦
南	十 冂 丫 二
単	小 甲 一	小 日 十	小 曰 十
卙	甚 十
博	十 尃	十 甫 寸
卛	絲 言 十	糸 言 糸 十	䜌 十
卜	丨 丶
卝	一 丨 丨 一
卞	丶 下
卟	口 卜
占	卜 口
卡	上 卜	上 下
卣	卜 囙
卥	卜 囪
卦	圭 卜
卨	卜 咼
卩	丨 ㇆
卪	卩 丶
卬	匚 卩
卭	工 卩
卮	厂 一 卩	厂 一 㔾
卯	卬 丿	匸 丿 卩
印	卬 一	匸 一 卩
危	厃 卩	刀 厂 卩	厃 㔾	刀 厂 㔾
卲	召 卩
即	艮 卩
卵	卯 丶 丶	匸 丿 丶 卪
卶	多 卩
卷	丷 夫 卩	𠔉 㔾
卸	午 止 卩
卹	血 卩
卺	丞 卩	丞 㔾
卻	谷 卩
卼	兀 危
卽	白 匕 卩
卾	咢 卩
卿	卯 艮 卩	匸 丿 即
厀	桼 卩
厃	刀 厂
厄	厂 卩	厂 㔾
厇	厂 乇
厈	厂 干
厊	厂 牙
厎	厂 氐
厏	厂 乍
厒	厂 缶
厓	厂 圭
厔	厂 至
厖	厂 尨
厗	厂 辛
厙	厂 車
厚	厂 日 子
厛	厂 听
厜	厂 垂
厝	厂 昔
厞	厂 非
原	厂 白 小	厂 泉
厡	厂 泉
厤	厂 秝
厥	厂 欮
厧	厂 真
厪	厂 堇
厫	厂 敖
厬	厂 晷
厭	厂 猒
厯	厂 林 乚 丶 丶
厰	厂 敞
厱	厂 僉
厲	厂 萬
厳	小 厂 敢
厴	厭 甲	厂 猒 甲
厵	原 原 原
厶	𠃊 丶
厷	一 丿 厶
厸	厶 厶
厹	九 厶
厺	大 厶
去	土 厶
厽	厶 厶 厶
厾	乁 去
叀	一 由 厶
參	厽 人 彡	厶 厶 厶 人 彡
叄	厽 人 三	厶 厶 厶 人 三
叅	厽 人 心	厽 人 小 丶
叉	又 丶
及	乃 乀
友	一 丿 又
反	厂 又
収	丩 又
叏	乛 支
叐	丿 友
叒	又 又 又
叓	十 口 又	支 口
叔	上 小 又	尗 又
叕	又 又 又 又
取	耳 又
受	爪 冖 又	爫 冖 又
叚	尸 二 又
叛	半 反
叜	灾 又
叝	去 及
叞	尸 示 又
叟	臼 丨 又
叡	睿 又
叢	丵 取	业 丷 二 丨 取	业 羊 取
口	丨 乛 一	冂 一
古	十 口
句	勹 口
另	口 力
叧	口 刀
叨	口 刀
叩	口 卩
只	口 八
叫	口 丩
召	刀 口
叭	口 八
叮	口 丁
可	一 口 亅	丁 口
台	厶 口
叱	口 匕
史	口 乂
右	一 丿 口
叴	九 口
叵	匚 口
司	㇆ 一 口
叺	口 入
叻	口 力
叼	口 刁
叿	口 工
吀	口 千
吁	口 于
吂	亡 口
吃	口 乞
各	夂 口
吅	口 口
吆	口 幺
吇	口 子
合	人 一 口
吉	士 口
吋	口 寸
同	冂 一 口
名	夕 口
后	厂 一 口
吏	一 口 乂	一 口 丿 乀
吐	口 土
向	丶 冂 口
吒	口 宅
吓	口 下
吔	口 也
吖	口 丫
吘	口 午
吙	口 火
吚	口 尹
君	尹 口
吜	口 丑
吝	文 口
吞	天 口
吟	口 今
吠	口 犬
吡	口 比
吢	心 口
吣	口 心
吤	口 介
吥	口 不
否	不 口
吧	口 巴
吩	口 分
吪	口 化
含	今 口
吭	口 亢
吮	口 允
吰	口 厷
吱	口 支
吲	口 引
吳	口 ㇉ 大
吵	口 少
吶	口 內
吷	口 夬
吸	口 及
吹	口 欠
吺	口 殳
吻	口 勿
吼	口 孔
吽	口 牛
吾	五 口
吿	牛 口
呀	口 牙
呁	口 勻
呂	口 丶 口
呃	口 厄
呄	乃 古
呅	口 文
呆	口 木
呇	水 口
呈	口 王
呉	口 ㇉ 一 八
告	牛 口
呋	口 夫
呌	口 斗
呍	口 云
呎	口 尺
呏	口 升
呑	夭 口
呔	口 太
呝	口 戹
呞	口 司
呟	口 玄
呠	口 本
呡	口 民
呢	口 尼
呤	口 令
呥	口 冉
呦	口 幼
呧	口 氐
周	冂 土 口
呩	口 示
呪	口 兄
呫	口 占
呬	口 四
呭	口 世
呮	口 只
呯	口 平
呰	此 口
呱	口 瓜
呲	口 此
味	口 未
呴	口 句
呵	口 可
呶	口 奴
呷	口 甲
呸	口 丕	口 不 一
呹	口 失
呺	口 号
呻	口 申
呼	口 乎
命	人 一 叩
呾	口 旦
呿	口 去
咀	口 且
咂	口 匝
咃	口 他
咄	口 出
咅	立 口
咆	口 包
咇	口 必
咈	口 弗
咉	口 央
咊	口 禾
咋	口 乍
和	禾 口
咍	口 台
咎	久 人 口	夂 人 口
咐	口 付
咑	口 打
咒	口 口 几
咓	口 瓦
咔	口 卡
咕	口 古
咖	口 加
咗	口 左
咘	口 布
咚	口 冬
咞	口 开
咟	口 百
咠	口 耳
咡	口 耳
咢	口 口 亏
咣	口 光
咤	口 宅
咥	口 至
咦	口 夷
咧	口 列
咨	次 口
咩	口 羊
咪	口 米
咫	尺 只
咬	口 交
咭	口 吉
咮	口 朱
咯	口 各
咰	口 旬
咱	口 自
咲	口 关
咳	口 亥
咴	口 灰
咵	口 夸
咶	口 舌
咷	口 兆
咸	戊 一 口
咹	口 安
咺	口 亘
咻	口 休
咼	冎 口	冂 ㇆ 冂 口
咽	口 因
咾	口 老
咿	口 伊
哀	衣 口
品	口 口 口
哂	口 西
哃	口 同
哄	口 共
哅	口 匈
哆	口 多
哇	口 圭	口 土 土
哈	口 合
哉	十 戈 口	土 戈 口	𢦏 口
哊	口 有
哋	口 地
哌	口 厂 氏	口 𠂢
响	口 向
哎	口 艾
哏	口 艮
哐	口 匡
哚	口 朵
哞	口 牟
哠	口 告
員	口 貝
哢	口 弄
哣	口 豆
哤	口 尨
哥	可 可
哦	口 我
哧	口 赤
哨	口 肖
哩	口 里
哪	口 那
哫	口 足
哬	口 何
哭	口 口 犬
哮	口 孝
哯	口 見
哰	口 牢
哱	口 孛
哲	折 口
哳	口 折
哴	口 良
哵	口 別
哶	口 芈	口 羊
哷	口 寽
哸	口 妥
哹	口 孚
哺	口 甫
哻	口 旱
哼	口 享
哽	口 更
哾	口 兑
哿	加 可
唀	口 秀
唁	口 言
唂	口 谷
唃	口 角
唄	口 貝
唅	口 含
唆	口 夋
唇	口 辰
唈	口 邑
唉	口 矣
唊	口 夾
唋	口 余
唌	口 延
唍	口 完
唎	口 利
唏	口 希
唐	广 肀 口	广 聿 口
唑	口 坐
唒	口 酉
唓	口 車
唔	口 吾
唕	口 早
唖	口 亜
唗	口 走
唘	石 又 口
唙	口 狄
唚	口 彐 冖 又
唞	口 抖
唣	口 皂
唥	口 冷
唦	口 沙
唧	口 即
唨	口 阻
唩	口 委
唪	口 奉
唫	口 金
唬	口 虎
唭	口 其
售	隹 口
唯	口 隹
唰	口 刷
唱	口 昌
唲	口 兒
唳	口 戻
唴	口 羌
唵	口 奄
唶	口 昔
唷	口 育
唸	口 念
唹	口 於
唺	口 典
唻	口 來
唼	口 妾
唽	口 析
唾	口 垂
唿	口 忽
啀	口 厓
啁	口 周
啂	口 乳
啃	口 肯
啄	口 豖
啅	口 卓
商	亠 丷 冂 儿 口	亠 丷 冏
啇	亠 丷 冂 古
啈	口 幸
啉	口 林
啊	口 阿
啋	口 采
啌	口 空
啍	口 享
啎	午 吾
問	門 口
啐	口 卒
啑	口 疌
啒	口 屈
啓	戶 攴 口	戶 攵 口
啔	戶 戈 口	户 戈 口
啕	口 匋
啖	口 炎
啗	口 陷
啘	口 宛
啙	此 口 口
啚	口 亠 回
啛	口 妻
啜	口 叕
啝	口 和
啞	口 亞
啟	戶 口 攴	戶 口 攵
啠	斤 斤 口
啡	口 非
啢	口 兩
啣	口 卸
啤	口 卑
啥	口 舍
啦	口 拉
啨	口 青
啩	口 卦
啪	口 拍
啫	口 者
啱	口 岩
啲	口 的
啳	口 卷
啵	口 波
啶	口 定
啷	口 郎
啺	口 昜
啻	帝 口
啼	口 帝
啽	口 弇
啾	口 秋
啿	口 甚
喀	口 客
喁	口 禺
喂	口 畏
喃	口 南
善	羊 丷 一 口
喅	口 昱
喆	吉 吉
喇	口 剌
喈	口 皆
喉	口 侯
喊	口 咸
喋	口 枼	口 世 木
喌	口 口 州
喍	口 柴
喎	口 咼
喏	口 若
喐	口 郁
喑	口 音
喒	口 昝
喓	口 要
喔	口 屋
喕	口 面
喖	口 枯
喗	口 軍
喘	口 耑	口 山 而
喙	口 彖
喚	口 奐
喛	口 爰
喜	士 口 丷 一 口
喝	口 曷
喞	口 卽
喟	口 胃
喠	口 重
喡	口 韋
喢	口 臿
喣	呴 火	呴 灬
喤	口 皇
喥	口 度
喦	品 山
喧	口 宣
喨	口 亮
喩	口 俞
喪	土 口 口 □
喫	口 契
喬	夭 口 冂 口
喭	口 彦
單	口 口 甲 一
喯	口 奔
喰	口 食
喱	口 厘
喲	口 約
喳	口 查
喴	口 威
喵	口 苗
営	小 冖 呂
喹	口 奎
喺	口 係
喻	口 俞
喼	口 急
喿	口 口 口 木
嗀	士 冖 一 口 殳
嗁	口 虒
嗂	口 月 缶	口 䍃
嗃	口 高
嗄	口 夏
嗅	口 臭
嗆	口 倉
嗇	土 人 人 回	土 人 人 囗 口
嗈	口 邕
嗉	口 素
嗊	口 貢
嗋	口 脅
嗌	口 益
嗍	口 朔
嗎	口 馬
嗏	口 茶
嗐	口 害
嗑	口 盍	口 去 皿
嗒	口 荅
嗓	口 桑
嗔	口 真
嗕	口 辱
嗖	口 叟
嗗	口 骨
嗘	口 奚
嗙	口 旁
嗚	口 烏
嗛	口 兼
嗜	口 耆	口 老 日
嗝	口 鬲
嗞	口 兹
嗟	口 差
嗠	孚 各
嗡	口 翁
嗢	口 昷
嗣	口 冊 司
嗤	口 蚩
嗥	口 皋
嗦	口 索
嗨	口 海
嗩	口 小 貝
嗪	口 秦
嗬	口 荷
嗮	口 晒
嗯	口 恩
嗰	口 個
嗱	口 拿
嗲	口 爹
嗵	口 通
嗶	口 畢
嗷	口 敖
嗸	敖 口
嗹	口 連
嗺	口 崔
嗻	口 庶
嗼	口 莫
嗽	口 欶	口 束 欠
嗾	口 族
嗿	口 貪
嘀	口 啇
嘁	口 戚
嘂	吕 丩 吕	口 口 丩 口 口
嘃	口 庸
嘄	口 梟
嘅	口 既
嘆	口 革 大
嘇	口 參
嘈	口 曹
嘉	吉 丷 一 加	士 口 丷 一 加
嘊	口 崖
嘋	口 教
嘌	口 票
嘍	口 婁
嘎	口 戛
嘏	古 叚
嘐	口 翏
嘑	口 虖
嘒	口 彗
嘓	口 國
嘔	口 區
嘕	口 焉
嘖	口 責
嘗	尚 旨
嘙	口 婆
嘚	口 得
嘛	口 麻
嘜	口 麥
嘝	口 斛
嘞	口 勒
嘟	口 都
嘠	口 百 冖 戈
嘡	口 堂
嘢	口 野
嘣	口 朋
嘥	口 徙
嘦	只 要
嘧	口 密
嘨	口 粛
嘩	口 華
嘪	口 買
嘫	口 然
嘬	口 最
嘭	口 彭
嘮	口 勞
嘯	口 肅
嘰	口 幾
嘲	口 朝
嘳	口 貴
嘴	口 觜
嘵	口 堯
嘶	口 斯
嘷	口 臯
嘸	口 無
嘹	口 尞
嘺	口 喬
嘻	口 喜
嘼	口 口 田 一 口
嘽	口 單
嘾	口 覃
嘿	口 黑
噀	口 巽
噁	口 惡
噂	口 尊
噃	口 番
噄	口 潔
噅	口 為
噆	口 旡 旡 日	口 朁
噇	口 童
噈	口 就
噉	口 敢
噊	口 矞
噋	口 敦
噌	口 曽	口 曾
噍	口 焦
噎	口 壹
噏	口 翕
噐	口 口 工 口 口
噑	口 皐
噒	口 粦
噓	口 虛
噔	口 登
噕	爲 口
噖	口 琴
噗	口 菐
噘	口 厥
噙	口 禽
噚	口 尋
噛	口 歯
噝	口 絲
噞	口 僉
噟	广 倠 口	广 人 隹 口	广 亻 隹 口
噠	口 達
噡	口 詹
噢	口 奥
噣	口 蜀
噤	口 禁
噥	口 農
噦	口 歲
噧	口 萬
器	口 口 大 口 口
噩	王 口 口 口 口	一 口 口 一 口 口 一 丨
噪	口 喿	口 品 木
噫	口 意
噬	口 筮
噭	口 敫
噮	口 睘
噯	口 愛
噰	口 雍
噱	口 豦
噲	口 會
噳	口 虞
噴	口 賁
噵	道 口
噶	口 葛
噷	口 歆
噸	口 頓
噹	口 當
噻	口 塞
噼	口 辟
噽	喜 丕
噾	口 窨
噿	口 翠
嚀	口 寧
嚁	口 翟
嚂	口 監
嚃	口 遝
嚄	口 蒦
嚅	口 需
嚆	口 蒿
嚇	口 赫
嚈	口 厭
嚉	口 對
嚊	口 鼻
嚋	口 壽
嚌	口 齊
嚍	口 盡
嚎	口 豪
嚏	口 疐
嚐	口 嘗
嚓	口 察
嚔	口 十 冖 田 厶 卜 人
嚕	口 魯
嚖	口 慧
嚗	口 暴
嚘	口 憂
嚙	口 齒
嚚	口 口 臣 口 口
嚛	口 樂
嚜	口 墨
嚝	口 廣
嚞	吉 吉 吉
嚟	口 黎
嚠	口 劉
嚢	十 口 冖 八 井 一 
嚤	口 摩
嚥	口 燕
嚦	口 歷
嚧	口 盧
嚨	口 龍
嚩	口 縛
嚪	口 閻
嚫	口 親
嚬	口 頻
嚭	喜 否
嚮	鄉 向
嚯	口 霍
嚰	口 磨
嚱	口 戲
嚲	享 單
嚳	臼 爻 冖 告	𦥯 告
嚴	口 口 厂 敢
嚵	口 毚
嚶	口 嬰
嚷	口 襄
嚸	口 點
嚹	口 罅
嚺	口 目 遂	口 网 遂	口 罒 遂
嚻	口 口 頁 口 口	吕 頁 吕
嚼	口 爵
嚽	口 贅
嚾	口 雚
嚿	口 舊
囀	口 轉
囁	口 聶
囂	口 口 頁 口 口
囃	口 雜
囄	口 離
囅	單 展
囆	口 蠆
囇	口 麗
囈	口 藝
囉	口 羅
囊	一 口 丨 冂 口 口 井 一 
囋	口 贊
囌	口 蘇
囍	喜 喜	士 口 丷 一 口 士 口 丷 一 口
囏	革 大 喜
囐	口 獻
囑	口 屬
囒	口 蘭
囓	口 齧	口 丰 刀 齒
囔	口 囊
囗	冂 一	丨 乛  一
囘	冂 巳	冂 已
囚	囗 人
四	囗 儿
囜	囗 厶
囝	囗 子
回	囗 口
囟	丶 囗 乂
因	囗 大
囡	囗 女
団	囗 寸
囤	囗 屯
囥	囗 亢
囦	囗 水
囧	囗 儿 冂
囨	囗 不
囩	囗 云
囪	丶 囗 丿 丿 丶
囫	囗 勿
囬	囗 丨 丨 一 一
囮	囗 化
囯	囗 王
困	囗 木
囱	丶 囗 夕
囲	囗 井
図	囗 乂 丶 丶
囶	囗 八 土
囷	囗 禾
囸	囗 正
囹	囗 令
固	囗 古
囻	囗 民
囼	囗 台
囿	囗 有
圀	囗 儿 方
圁	囗 言
圂	囗 豕
圃	囗 甫
圄	囗 吾
圅	龴 囗 丷 干
圇	囗 侖
圈	囗 卷
圉	囗 幸
圊	囗 青
國	囗 或
圌	囗 耑
圍	囗 韋
圎	囗 貟
圏	囗 卷
圐	囗 目 方	囗 网 方	囗 罒 方
圑	囗 尃
園	囗 袁
圓	囗 員
圔	囗 盍
圖	囗 啚
圗	囗 厶 面
團	囗 專
圙	囗 八 面
圚	囗 貴
圛	囗 睪
圜	囗 睘
圝	囗 絲 言	囗 糸 言 糸	囗 䜌
圞	囗 欒
土	十 一
圠	土 乚
圡	土 丶
圢	土 丁
圤	土 卜
圥	土 儿
圧	厂 土
在	一 人 土	一 亻 土
圩	土 于
圪	土 乞
圫	土 乇
圬	土 亏
圭	土 土
圮	土 己
圯	土 已	土 巳
地	土 也
圱	千 土
圲	土 千
圳	土 川
圴	土 勺
圵	土 上
圶	大 土
圻	土 斤
圼	日 土
圽	土 勿
圾	土 及
圿	土 介
址	土 止
坁	土 氏
坂	土 反
坃	土 元
坄	土 殳
坅	土 今
坆	土 攴	土 攵
均	土 勻
坈	土 冗
坉	土 屯
坊	土 方
坋	土 分
坌	土 分
坍	土 丹
坎	土 欠
坐	人 人 土
坑	土 亢
坒	比 土
坓	井 土
坔	土 水
坕	爪 土
坖	土 元
坘	土 互
坙	一 巛 土
坡	土 皮
坢	土 半
坣	小 冖 土	丷 宀 土
坤	土 申
坥	土 且
坦	土 旦
坧	土 石
坨	土 它
坩	土 甘
坪	土 平
坫	土 占
坬	土 瓜
坭	土 尼
坮	土 台
坯	土 丕
坰	土 冋
坱	土 央
坲	土 弗
坳	土 幼
坴	土 八 土
坵	土 丘
坶	土 母
坷	土 可
坸	土 句
坹	土 穴
坺	土 犮
坻	土 氐
坼	土 斥
坽	土 令
坾	土 宁
坿	土 付
垀	土 乎
垁	土 矢
垂	丿 二 土 丨 丨
垃	土 立
垇	土 凹
垉	土 包
型	刑 土
垌	土 同
垍	土 自
垎	土 各
垏	土 聿
垐	次 土
垑	土 多
垓	土 亥
垔	西 土	覀 土
垕	后 土
垖	土 戶 乛 一	土 户 乛 一
垗	土 兆
垘	土 伏
垙	土 光
垚	土 土 土
垛	土 朵
垜	土 朶
垝	土 危
垞	土 宅
垟	土 羊
垠	土 艮
垡	伐 土
垢	土 后
垣	土 亘
垤	土 至
垥	土 合
垧	土 向
垨	土 守
垬	土 共
垮	土 夸
垵	土 安
垶	土 辛
垷	土 見
垸	土 完
垹	土 邦
垺	土 孚
垻	土 貝
垼	役 土
垽	沂 土
垾	土 旱
垿	土 序
埀	乖 二	乖 土
埁	土 岑
埂	土 更
埃	土 矣
埄	土 夆
埅	防 土
埆	土 角
埇	土 甬
埈	土 夋
埉	土 夾
埊	山 水 土
埋	土 里
埌	土 良
埍	土 肙
城	土 成
埏	土 延
埐	土 彐 冖 又
埑	折 土
埒	土 寽
埓	土 寽
埔	土 甫
埕	土 呈
埗	土 步
埛	土 冏
埜	林 土
埝	土 念
埞	土 定
域	土 或
埠	土 阜
埡	土 亞
埢	土 卷
埣	土 卒
埤	土 卑
埥	土 青
埦	土 宛
埧	土 具
埨	土 侖
埩	土 爭
埪	土 空
埫	土 尚
埬	土 東
埭	土 隶
埮	土 炎
埯	土 奄
埰	土 采
埱	土 叔
埲	土 奉
埳	土 臽
埴	土 直
埵	土 垂
埶	坴 丸
執	幸 丸
埸	土 易
培	土 咅
基	其 土
埻	土 享
埼	土 奇
埽	土 帚
埾	取 土
埿	泥 土
堀	土 屈
堁	土 果
堂	尚 土
堃	方 方 土
堄	土 兒
堅	臤 土
堆	土 隹
堇	廿 口 丰
堈	土 岡
堉	土 育
堊	亞 土
堋	土 朋
堌	土 固
堍	土 兔
堎	土 夌
堐	土 厓
堓	土 岸
堖	土 巛 丶 囗 乂
堗	土 突
堘	土 丷 夫 土	土 𠔉 土
堙	土 西 土
堚	土 軍
堛	土 畐
堜	土 柬
堝	土 咼
堞	土 枼
堟	土 彖
堠	土 侯
堡	保 土
堢	土 保
堣	土 禺
堤	土 是
堥	敄 土
堦	土 皆
堧	土 耎
堨	土 曷
堩	土 恆
堪	土 甚
堫	土 凶 八 夕	土 凶 八 夂
堬	土 俞
堭	土 皇
堮	土 咢
堯	垚 兀
堰	土 匽
報	幸 卩 又
堲	即 土
堳	土 眉
場	土 昜
堵	土 者
堶	土 左 月
堷	土 音
堸	土 風
堹	土 重
堺	土 界
堻	津 土
堼	封 土
堽	土 罡
堾	土 春
堿	土 咸
塂	土 巷
塃	土 荒
塄	土 目 方	土 罒 方
塅	土 段
塇	土 宣
塈	既 土
塉	土 脊
塊	土 鬼
塋	火 火 冖 土	𤇾 土
塌	土 日 羽	土 曰 羽
塍	肉 丷 夫 土	月 丷 夫 土	肉 𠔉 土
塎	土 容
塏	土 豈
塐	土 素
塑	朔 土
塒	土 時
塓	土 冥
塔	土 荅
塕	土 翁
塖	土 乘
塗	涂 土	水 余 土
塘	土 唐
塙	土 高
塚	土 冢
塛	土 栗
塜	土 冡
塝	土 旁
塞	宀 井 大 土
塟	草 死 土	艸 死 土	艹 死 土
塠	土 追
塡	土 眞
塢	土 烏
塣	浧 土
塤	土 員
塥	土 鬲
塦	陣 土
塧	土 益
塨	土 恭
塩	土 土 丿 一 口 皿
塪	土 舀
填	土 真
塬	土 原
塭	土 昷
塮	土 射
塯	土 留
塱	朗 土
塲	土 人 丿 一 昜
塳	土 逢
塴	土 朋
塵	鹿 土
塶	土 鹿
塷	土 鹵
塸	土 區
塹	斬 土
塺	麻 土
塻	土 莫
塼	土 專
塽	土 爽
塾	孰 土
塿	土 婁
墀	土 犀
墁	土 曼
墂	土 票
境	土 竟
墄	土 戚
墅	野 土
墆	土 帶
墇	土 章
墈	土 勘
墉	土 庸
墊	執 土
墋	土 參
墌	土 庶
墍	旣 土
墎	土 郭
墏	將 土
墐	土 堇
墑	土 啇
墒	土 商
墓	莫 土
墔	土 崔
墕	土 焉
墖	土 畣
増	土 曽
墘	土 乾
墚	土 梁
墜	隊 土
墝	土 堯
增	土 曾
墟	土 虛
墠	土 單
墡	土 善
墢	土 發
墣	土 菐
墤	土 貴
墥	土 童
墦	土 番
墧	土 喬
墨	黑 土
墩	土 敦
墪	敦 土
墫	土 尊
墬	阜 彖 土	阝 彖 土
墭	土 盛
墮	隋 土
墯	惰 土
墰	土 覃
墱	土 登
墲	土 無
墳	土 賁	土 十 十 十 貝	土 十 艹 貝
墴	土 黃
墵	土 雲
墶	土 達
墷	土 華
墺	土 奧
墻	土 嗇
墼	車 凵 殳 土
墽	土 敫
墾	豸 艮 土
墿	土 睪
壀	土 辟
壁	辟 土
壂	殿 土
壃	土 畺
壄	楙 土
壅	雍 土
壆	臼 爻 冖 土	𦥯 土
壇	土 亶
壈	土 稟
壉	土 豦
壊	土 十 目 衣	土 十 网 衣	土 十 罒 衣
壋	土 當
壌	土 衣 八 井 一
壍	漸 土
壎	土 熏
壏	土 監
壐	爾 土
壑	卜 冖 一 谷 又 土
壒	土 蓋
壓	厭 土
壔	土 壽
壕	土 豪
壖	土 需
壘	畾 土	田 田 田 土
壙	土 廣
壚	土 盧
壛	土 閻
壜	土 曇
壝	土 遺
壞	土 褱
壟	土 龍
壠	土 龍
壡	睿 圣
壢	土 歷
壣	土 聯
壤	土 襄
壦	土 雚
壧	土 嚴
壨	田 田 田 田 土
壩	土 霸
士	十 一
壬	丿 士
壯	爿 士
壱	士 冖 匕
売	士 冖 儿
壴	十 豆	士 口 丷 一
壵	士 士 士
壷	士 冖 亜
壹	士 冖 豆
壺	士 冖 □	士 冖 亞
壻	土 胥
壼	士 冖 亞
壽	士 乛 工 一 口 寸
壾	壴 巨
壿	土 尊
夀	韦 口 一 口 寸	韦 口 一 吋
夁	士 目 固	士 罒 固
夂	丿 丿 乀
夅	夕 匸 丨	夂 匸 丨
夆	夂 丰
変	亦 夂
夋	厶 八 夂
夌	土 八 夂
夎	坐 夂
夏	一 自 夕	一 自 夂
夐	刀 罓 目 夂
夒	一 自 止 已 八 夕	一 自 止 已 八 夂
夓	夏 夂
夔	丷 一 止 自 卩 夕	丷 一 止 自 卩 夂
夕	丿 丿 丶
外	夕 卜
夗	夕 卩	夕 㔾
夘	夕 卩
夙	几 歹
多	夕 夕
夛	彐 夕
夜	亠 人 夕 丶	亠 亻 夕 丶
夝	夕 生
夠	多 句
夡	多 吉
夢	草 网 冖 夕	艸 网 冖 夕	艹 罒 冖 夕
夣	亠 厶 网 冖 夕	亠 厶 罒 冖 夕
夤	夕 寅
夥	果 多
夥	果 多
夦	甚 多
大	人 一
夨	𠃊 大
天	一 大
太	大 丶
夫	一 大	二 人
夬	乛 大
夭	丿 大
央	冂 大
夯	大 力
夰	大 丿 丨
失	丿 夫	丶 夫
夲	大 十
夳	大 二
夵	大 小
夶	大 大
夷	大 弓	一 弓 人
夸	大 亏
夼	大 川
夽	大 云
夾	大 人 人
夿	大 巴
奀	不 大
奃	大 氐
奄	大 电
奅	大 卯
奆	大 巨
奇	大 可
奈	大 示
奉	手 乀 一 十	龹 一 十
奊	丨 一 圭 大
奌	占 大
奎	大 圭	大 土 土
奏	手 乀 夭	龹 夭
奐	刀 冂 儿 大
契	丰 刀 大
奒	大 亥
奓	大 多
奔	大 卉
奕	亦 大
套	大 镸
奘	壯 大
奙	厶 大 电
奚	爪 幺 大	爫 幺 大
奛	大 明
奜	非 大
奝	大 周
奞	大 隹
奟	大 朋
奠	酋 大
奡	一 自 夰
奢	大 者
奣	天 明
奤	大 面
奦	務 大
奧	丶 冂 采 大	丶 冂 釆 大
奨	将 大
奩	大 區
奪	大 隹 寸
奫	大 淵
奭	大 百 百
奮	大 隹 田
奯	大 歲
奰	目 目 目 大	罒 罒 罒 大
奱	絲 言 大	糸 言 糸 大	䜌 大
奲	奢 單
女	𠃊 一 丿
奴	女 又
奵	女 丁
奶	女 乃
奷	女 千
奸	女 干
她	女 也
奺	女 久
奻	女 女
奼	女 乇
好	女 子
奾	女 山
奿	丸 女
妀	己 女
妁	女 勺
如	女 口
妃	女 己
妄	亡 女
妅	女 工
妉	女 冘
妊	女 壬
妋	女 夫
妌	女 井
妍	女 开
妎	女 介
妏	女 文
妐	女 公
妑	女 巴
妒	女 戶	女 户	女 戸
妓	女 支
妔	女 亢
妕	女 中
妖	女 夭
妗	女 今
妘	女 云
妙	女 少
妚	女 不
妜	女 夬
妝	爿 女
妞	女 丑
妟	日 女
妠	女 內
妡	女 斤
妢	女 分
妣	女 比
妤	女 予
妥	爪 女	爫 女
妦	女 丰
妧	女 元
妨	女 方
妬	女 石
妭	女 犮
妮	女 尼
妯	女 由
妰	女 乍
妱	女 召
妲	女 旦
妳	女 尔
妴	夗 女
妵	女 主
妶	女 玄
妷	女 失
妸	女 可
妹	女 未
妺	女 末
妻	一 聿 女	一 肀 女
妼	女 必
妽	女 申
妾	立 女
妿	加 女
姀	女 禾
姁	女 句
姂	女 乏
姃	女 正
姄	女 民
姅	女 半
姆	女 母
姇	付 女
姈	女 令
姉	女 市
姊	女 丿 ㇉ 丨 丿	女 𠂔
始	女 台
姌	女 冉
姍	女 冊
姎	女 央
姏	女 甘
姐	女 且
姑	女 古
姒	女 以
姓	女 生
委	禾 女
姕	此 女
姖	女 巨
姘	女 并	女 幷
姙	女 任
姚	女 兆
姛	女 同
姜	羊 女
姝	女 朱
姞	女 吉
姟	女 亥
姠	女 向
姡	女 舌
姢	女 厶 肉	女 厶 月
姣	女 交
姤	女 后
姥	女 老
姦	女 女 女
姧	女 女 干
姨	女 夷
姩	女 年
姪	女 至
姫	女 臣
姬	女 匸 丨 口 丨
姭	劦 女
姮	女 亘
姯	女 光
姰	女 旬
姱	女 夸
姲	女 安
姳	女 名
姴	列 女
姵	女 几 帀
姶	女 合
姷	女 有
姸	女 幵
姹	女 宅
姺	女 先
姻	女 因
姼	女 多
姽	女 危
姾	女 全
姿	次 女
娀	女 戎
威	戊 一 女
娂	女 共
娃	女 圭	女 土 土
娉	女 甹
娊	女 見
娋	女 肖
娌	女 里
娍	女 成
娎	折 女
娏	女 尨
娑	沙 女
娒	女 每
娓	女 尾
娔	女 克
娕	女 束
娖	女 足
娗	女 廷
娘	女 良
娙	女 巠
娚	女 男
娛	女 吳
娜	女 那
娝	女 否
娞	女 妥
娟	女 肙	女 口 月
娠	女 辰
娡	女 志
娢	女 含
娣	女 弟
娤	壯 女
娥	女 我
娦	女 兵
娧	女 兌	女 兑
娨	女 旱
娩	女 免
娪	女 吾
娫	女 延
娬	女 武
娭	女 矣
娮	女 言
娯	女 呉
娰	女 似
娵	女 取
娶	取 女
娷	女 垂
娸	女 其
娹	女 弦
娺	女 叕
娻	女 東
娼	女 昌
娽	女 录
娾	女 厓
娿	阿 女
婀	女 阿
婁	口 十 口 女	口 一 中 女
婂	女 帛
婃	女 宗
婄	女 咅
婅	女 匊
婆	波 女
婇	女 采
婈	女 夌
婉	女 宛
婊	女 表
婋	女 虎
婌	女 叔
婍	女 奇
婎	女 隹
婏	女 兔
婐	女 果
婑	女 委
婒	女 炎
婓	非 女
婕	女 疌
婖	女 忝
婗	女 兒
婘	女 卷
婙	女 争
婚	女 昏
婛	女 京
婜	臣 又 女
婝	女 定
婞	女 幸
婟	女 固
婠	女 官
婡	女 來
婢	女 卑
婣	女 片 一 爿
婤	女 周
婥	女 卓
婦	女 彐 冖 巾
婧	女 青
婨	女 侖
婩	女 岸
婪	林 女	木 木 女
婫	女 昆
婬	女 爪 壬	女 爫 壬
婭	女 亞
婯	丽 女
婰	女 典
婱	弦 女
婷	女 亭
婸	女 昜
婹	女 要
婺	敄 女
婻	女 南
婼	女 若
婽	女 叚
婾	女 俞
婿	女 胥
媀	女 禺
媁	女 韋
媂	女 帝
媃	女 柔
媄	女 美
媅	女 甚
媆	女 耎
媇	女 亲
媉	女 屋
媊	女 前
媋	女 春
媌	女 苗
媍	女 負
媎	女 者
媏	女 耑
媐	巸 女
媑	女 重
媒	女 某
媓	女 皇
媔	女 面
媕	女 弇
媖	女 英
媗	女 宣
媙	女 威
媚	女 眉
媛	女 爰
媜	女 貞
媝	秋 女
媞	女 是
媟	女 枼
媠	女 左 月
媡	女 柬
媢	女 冒
媣	女 染
媤	女 思
媥	女 扁
媦	女 胃
媧	女 咼
媨	女 酋
媩	女 胡
媮	女 俞
媯	女 為
媰	女 芻
媱	女 月 缶	女 䍃
媲	女 囟 比
媳	女 息
媴	女 袁
媵	肉 丷 夫 女	月 𠔉 女	肉 𠔉 女	月 𠔉 女
媶	女 茸
媷	女 辱
媸	女 蚩
媹	女 留
媺	女 彳 山 一 儿 攴
媻	般 女
媼	女 昷
媽	女 馬
媾	女 冓
媿	女 鬼
嫀	女 秦
嫁	女 家
嫂	女 叟
嫃	女 真
嫄	女 原
嫅	女 差
嫆	女 容
嫇	女 冥
嫈	火 火 冖 女	𤇾 女
嫉	女 疾
嫊	女 素
嫋	女 弱
嫌	女 兼
嫍	女 舀
嫎	女 旁
嫏	女 郎
嫐	女 男 女
嫑	不 要
嫓	女 刀 内 比
嫕	女 悘
嫖	女 票
嫗	女 區
嫘	女 累
嫙	女 旋
嫚	女 曼
嫛	殹 女
嫜	女 章
嫝	女 康
嫞	女 庸
嫟	女 匿
嫠	未 攵 厂 女
嫡	女 啇
嫢	規 女
嫣	女 焉
嫤	女 堇
嫥	女 專
嫦	女 常
嫧	女 責
嫨	女 革 大
嫩	女 敕
嫪	女 翏
嫫	女 莫
嫬	女 庶
嫭	女 虖
嫮	女 雩
嫯	敖 女
嫰	女 欶
嫳	敝 女
嫴	女 辜
嫵	女 無
嫶	女 焦
嫷	女 隋
嫸	女 善
嫹	女 黃
嫺	女 閒
嫻	女 閑
嫼	女 墨
嫽	女 尞
嫾	女 粦
嫿	女 畫
嬀	女 爲
嬁	女 登
嬂	女 戠
嬃	須 女
嬅	女 華
嬆	女 翕
嬇	女 貴
嬈	女 堯
嬉	女 喜
嬊	廿 北 口 女
嬋	女 單
嬌	女 喬
嬍	女 彳 山 一 王 攴	女 彳 山 一 王 攵
嬎	女 免 生
嬏	女 番
嬐	女 僉
嬑	女 意
嬒	女 會
嬓	女 敫
嬔	女 免 生
嬕	女 睪
嬖	辟 女
嬗	女 亶
嬘	女 遂
嬙	女 嗇
嬚	女 廉
嬛	女 睘
嬝	女 裊
嬞	女 董
嬟	女 義
嬠	女 喿
嬡	女 愛
嬢	女 六 井 一 
嬣	女 寧
嬤	女 麻 幺
嬥	女 翟
嬦	女 壽
嬧	女 盡
嬨	女 慈
嬩	女 與
嬪	女 賓
嬬	女 需
嬭	女 爾
嬮	厭 女
嬯	女 臺
嬰	貝 貝 女
嬱	漸 女
嬲	男 女 男
嬴	亡 口 月 女 凡
嬵	女 綿
嬸	女 審
嬹	女 興
嬺	女 慝
嬻	女 賣
嬼	女 劉
嬾	女 賴
嬿	女 燕
孀	女 霜
孁	霝 女
孂	女 簋
孃	女 襄
孄	女 闌
孅	女 韱
孆	女 嬰
孇	女 雙
孈	女 巂
孉	女 雚
孊	女 靡
孋	女 麗
孌	絲 言 女	糸 言 糸 女	䜌 女
孍	女 嚴
孎	女 屬
孏	女 蘭
子	了 一
孑	了 丿
孒	了 一
孓	了 乀
孔	子 乙	子 乚
孕	乃 子
孖	子 子
字	宀 子
存	一 人 子	一 亻 子
孚	爪 子	爫 子
孛	十 冖 子
孜	子 攴	子 攵
孝	老 子	耂 子
孞	子 心
孟	子 皿
孠	司 子
孡	子 台
孢	子 包
季	禾 子
孤	子 瓜
孥	奴 子
孨	子 子 子
孩	子 亥
孫	子 系
孬	不 好
孭	子 貝
孮	子 宗
孯	臣 又 子
孰	享 丸
孱	尸 孨	尸 子 子 子
孲	子 亞
孴	孨 日
孵	卵 孚
孶	茲 子
孷	未 攵 厂 子
學	臼 爻 冖 子	𦥯 子
孹	辟 子
孺	子 需
孻	子 盡
孼	辥 子
孽	薛 子
孾	子 嬰
孿	絲 言 子	糸 言 糸 子	䜌 子
宀	丶 冖
宂	宀 几
它	宀 匕
宄	宀 九
宅	宀 乇
宆	宀 弓
宇	宀 于
守	宀 寸
安	宀 女
宊	宀 犬
宋	宀 木
完	宀 元
宍	宀 六
宎	宀 夭
宏	宀 厷
宐	宀 彑
宑	宀 井
宒	宀 毛
宓	宀 必
宔	宀 主
宕	宀 石
宖	宀 弘
宗	宀 示
官	宀 㠯
宙	宀 由
定	宀 疋
宛	宀 夗
宜	宀 且
実	宀 二 大
客	宀 各
宣	宀 亘
室	宀 至
宥	宀 有
宦	宀 臣
宨	宀 兆
宩	宀 米
宬	宀 成
宭	宀 君
宮	宀 呂	宀 口 丶 口
宯	宀 孝
宰	宀 辛
宱	宀 作
宲	宀 呆
害	宀 丰 口
宴	宀 妟
宵	宀 肖
家	宀 豕
宷	宀 釆
宸	宀 辰
容	宀 谷
宺	宀 口 一 川	向 一 川
宻	宀 又 丷 山
宼	宀 元 女
宿	宀 人 百	宀 亻 百
寀	宀 采
寁	宀 疌
寂	宀 叔
寃	宀 兔
寄	宀 奇
寅	宀 一 由 八
密	宀 必 山	宓 山
寇	宀 元 攴
寈	宀 青
寉	宀 隹
寊	宀 貞
寋	宀 井 大
富	宀 畐
寍	宀 心 皿
寎	宀 爿 丙
寏	宀 奐
寐	宀 爿 未
寑	宀 侵
寒	宀 井 大 冰	宀 井 大 冫
寓	宀 禺
寔	宀 是
寕	宀 一 丶 目 丁	宀 一 丶 罒 丁
寖	宀 浸
寗	宓 冉
寘	宀 真
寙	宀 瓜 瓜
寚	宀 王 缶
寛	宀 草 見	宀 艸 見	宀 艹 見
寜	宀 心 皿 亅
寞	宀 莫
察	宀 祭
寠	宀 婁
寡	宀 直 分
寢	宀 爿 彐 冖 又
寣	宀 爿 言
寤	宀 爿 吾
寥	宀 翏
實	宀 貫
寧	宀 心 皿 丁
寨	宀 一 共 木	宀 井 大 木
審	宀 番
寪	宀 為
寫	宀 舄
寬	宀 草 見 丶	宀 艸 見 丶	宀 艹 見 丶
寭	宀 惠
寮	宀 尞
寯	宀 雋
寰	宀 睘
寱	宀 爿 臬
寲	宀 疑
寳	宀 王 尔 貝
寴	宀 親
寵	宀 龍
寶	宀 王 缶 貝	宀 玉 缶 貝
寷	宀 豐
寸	一 亅 丶
寺	土 寸
寽	爪 寸	爫 寸
対	文 寸
尀	叵 寸
封	土 土 寸	圭 寸
専	一 由 寸
尃	甫 寸
射	身 寸
尅	克 寸
將	爿 肉 寸	爿 月 寸	爿 夕 寸
專	叀 寸	一 由 厶 寸
尉	尸 示 寸
尊	酋 寸
尋	彐 工 口 寸
尌	壴 寸
對	业 羊 寸
導	道 寸
小	八 亅
尐	小 乀
少	小 丿
尒	人 小
尓	丿 一 小
尕	乃 小
尖	小 大
尗	上 小
尙	小 冋	小 冂 口
尚	小 冂 口
尛	小 小 小
尜	小 大 小
尞	昚 小
尟	是 少
尠	甚 少
尢	一 人	一 丿 乚
尣	八 儿
尤	尢 丶	一 丿 乚 丶
尥	尢 勺
尦	尣 勺
尨	尤 彡
尩	尣 王
尪	尢 王
尫	兀 王
尬	尢 介
尭	卉 兀
尮	尢 朶
尯	尢 危
尰	尢 重
就	京 尤
尲	尢 兼
尳	尢 骨
尵	尢 貴
尶	兀 監
尷	尢 監
尸	㇆ 一 丿
尹	尸 一	彐 丿
尺	尸 乀
尻	尸 九
尼	尸 匕
尾	尸 毛
尿	尸 水
局	尸 ㇆ 口
屁	尸 比
屄	尸 穴
居	尸 古
屆	尸 凵 士
屇	尸 田
屈	尸 出
屋	尸 至
屌	尸 吊
屍	尸 死
屎	尸 米
屏	尸 并	尸 幷
屐	尸 彳 支
屑	尸 肖
屒	尸 辰
屓	尸 貝
屔	丘 尼
展	尸 龷 
屖	尸 辛
屘	尾 子
屙	尸 阿
屚	尸 雨
屛	尸 幷
屜	尸 彳 世
屝	尸 非
屟	尸 枼
屠	尸 者
屢	尸 婁
屣	尸 徙
層	尸 曽	尸 曾
履	尸 復
屧	尸 彳 枼
屨	尸 彳 婁
屩	尸 彳 喬
屪	尸 尞
屫	尸 爿 喬
屬	尸 二 丨 二 蜀
屭	尸 贔
屮	凵 丨
屯	丿 凵 乚
屰	丷 一 山	丷 一 屮
山	凵 丨
屳	入 山
屴	山 力
屵	山 厂
屸	山 工
屹	山 乞
屺	山 己
屻	山 刃
屼	山 兀
屽	山 干
屾	山 山
岄	山 月
岅	山 反
岆	山 夭
岇	山 卬
岈	山 牙
岉	山 勿
岊	巴 山
岋	山 及
岌	山 及
岍	山 开
岎	山 分
岏	山 元
岐	山 支
岑	山 今
岒	山 今
岓	山 斤
岔	分 山
岕	山 介
岙	夭 山
岜	山 巴
岝	山 乍
岞	山 乍
岟	山 央
岠	山 巨
岡	冂 丷 一 山
岢	山 可
岣	山 句
岤	山 穴
岥	山 皮
岦	山 立
岧	山 召
岨	山 且
岩	山 石
岪	山 弗
岫	山 由
岬	山 甲
岮	山 它
岯	山 丕
岰	山 幼
岱	代 山
岲	山 兄
岳	丘 山
岴	山 丘
岵	山 古
岶	山 白
岷	山 民
岸	山 厈	山 厂 干
岹	山 召
岺	山 令
岻	山 氐
峀	山 田
峁	山 卯
峂	山 冬
峆	山 合
峇	山 合
峈	山 各
峉	山 各
峊	戶 乛 一 山	户 乛 一 山
峋	山 旬
峌	山 至
峍	山 聿
峎	山 艮
峏	山 而
峐	山 亥
峑	山 全
峒	山 同
峓	山 夷
峔	山 老
峕	山 亠 日
峖	山 安
峗	山 危
峘	山 亘
峙	山 寺
峚	山 圶
峛	山 列
峜	山 企
峝	山 同
峞	山 危
峟	山 有
峠	山 上 下
峢	山 列
峧	山 交
峨	山 我
峩	山 我
峪	山 谷
峫	山 邪
峬	山 甫
峭	山 肖
峮	山 君
峯	山 夆
峰	山 夆
峱	丑 山
峲	山 利
峳	山 攸
峴	山 見
峵	山 宏
島	丶 彐 一 勹 山
峷	山 辛
峸	山 成
峹	余 山
峺	山 更
峻	山 夋
峼	山 告
峽	山 夾
峾	沂 山
峿	山 吾
崀	山 良
崁	山 坎
崅	山 角
崆	山 空
崇	山 宗
崈	宗 山
崉	山 沓
崌	山 居
崍	山 來
崎	山 奇
崏	山 昏
崐	山 昆
崑	山 昆
崒	山 卒
崓	山 固
崔	山 隹
崕	山 厓
崖	山 厓
崗	山 岡
崘	山 侖
崙	山 侖
崚	山 夌
崛	山 屈
崜	山 垂
崝	山 青
崞	山 享
崟	山 金
崠	山 東
崡	山 函
崢	山 爭
崣	山 委
崤	山 肴
崥	山 卑
崦	山 奄
崧	山 松
崩	山 朋
崪	山 卒
崫	山 屈
崬	山 東
崮	山 固
崯	山 金
崱	山 則
崲	山 皇
崳	山 俞
崴	山 威
崵	山 昜
崶	山 封
崷	山 酋
崸	山 頁
崹	山 帝
崺	山 施
崻	山 待
崼	山 是
崽	山 思
崾	山 要
崿	山 咢
嵀	山 柱
嵁	山 甚
嵂	山 律
嵃	山 彦
嵄	山 美
嵅	山 咸
嵆	禾 尤 山
嵇	禾 尤 山
嵈	山 爰
嵉	山 亭
嵊	山 乘
嵋	山 眉
嵌	山 甘 欠
嵍	敄 山
嵎	山 禺
嵏	山 凶 八 夕	山 凶 八 夂
嵐	山 風
嵑	山 曷
嵒	品 山
嵓	山 品
嵔	山 畏
嵕	山 凶 八 夕	山 凶 八 夂
嵖	山 查
嵗	山 戊 丁 丶 丿	山 戊 一 小
嵛	山 俞
嵞	余 山 山
嵟	山 隹
嵠	山 奚
嵡	山 翁
嵢	山 倉
嵣	山 唐
嵤	火 火 冖 山	火 火 冚	𤇾 山
嵥	山 桀
嵦	山 豈
嵧	山 留
嵨	山 烏
嵩	山 高
嵪	山 高
嵫	山 兹
嵬	山 鬼
嵭	山 旁
嵮	山 真
嵯	山 差
嵰	山 兼
嵱	山 容
嵲	山 臬
嵳	山 差
嵴	山 脊
嵷	山 從
嵸	山 從
嵹	山 強
嵺	山 翏
嵼	山 產
嵽	山 帶
嵾	山 參
嵿	山 頂
嶀	山 雩
嶁	山 婁
嶂	山 章
嶃	山 斬
嶄	山 斬
嶅	敖 山
嶆	山 曹
嶇	山 區
嶈	山 將
嶉	山 唯
嶊	山 推
嶋	山 島
嶌	山 島
嶍	山 習
嶎	山 尉
嶏	山 厂 配
嶐	山 隆
嶑	山 象
嶒	山 曾
嶓	山 番
嶔	山 欽
嶕	山 焦
嶖	山 翕
嶗	山 勞
嶘	山 棧
嶙	山 粦
嶚	山 尞
嶛	山 尞
嶜	山 旡 旡 日	山 朁
嶝	山 登
嶞	隋 山
嶟	山 尊
嶠	山 喬
嶡	山 厥
嶢	山 堯
嶣	山 焦	崔 火	崔 灬
嶤	山 堯
嶥	山 厥
嶦	山 詹
嶧	山 睪
嶨	臼 爻 冖 山	𦥯 山
嶩	山 農
嶪	山 業
嶫	山 業
嶬	山 義
嶭	山 戶 乛 一 辛	山 户 乛 一 辛
嶮	山 僉
嶯	山 戢
嶰	山 解
嶱	山 葛
嶲	山 雋
嶳	山 豕 土 土
嶴	奧 山
嶵	山 罪
嶷	山 疑
嶸	山 榮
嶹	山 壽
嶺	山 領
嶻	山 截
嶼	山 與
嶽	山 獄
嶾	山 爪 工 彐 心	山 爫 工 彐 心	山 㥯
巀	山 雀 戈
巁	山 厲
巂	山 隹 冏
巃	山 龍
巄	山 龍
巆	山 營
巇	山 戲
巈	山 鞠
巉	山 毚
巊	山 嬰
巋	山 歸
巌	山 厳
巍	山 魏
巎	山 夒
巏	山 雚
巐	山 高 昇
巑	山 贊
巒	絲 言 山	糸 言 糸 山	䜌 山
巓	山 顚
巔	山 顛
巖	山 嚴
巗	山 嚴
巘	山 獻
巙	山 夔
巚	山 獻
川	丿 丨 丨
州	川 丶 丶 丶
巟	亡 川
巠	一 巛 工
巡	辵 巛	辶 巛
巢	巛 果
巣	小 果	丶 丶 丶 果
巤	巛 囗 乂 𠄌 丶 丶 𠄌 丶 丶 乀
工	二 丨	一 丨 一
左	一 丿 工
巧	工 丂	工 万
巨	匚 乛 一	匸 ㇆ 一
巫	工 人 人
差	羊 丿 工
巰	巠 亠 厶 川	巠 巟	巠 㐬
己	㇆ 一 乚
已	㇆ 一 乚
巳	㇆ 一 乚
巴	巳 丨	巳 丶
巵	厂 一 巴
巶	召 巳
巷	共 己
巹	丞 己
巺	巳 巳 一 八
巻	丷 夫 己	𠔉 㔾
巽	己 己 共
巾	冂 丨
巿	一 巾
帀	丿 巾	一 巾 巿
市	亠 巾
布	一 丿 巾
帄	巾 丁
帆	巾 凡
帇	彐 巾
帉	巾 分
帊	巾 巴
帋	氏 巾
希	乂 布	乂 一 丿 巾
帍	戶 巾	户 巾	戸 巾
帎	巾 冘
帑	奴 巾
帒	代 巾
帓	巾 末
帔	巾 皮
帕	巾 白
帖	巾 占
帗	巾 犮
帘	奴 巾
帙	巾 失
帚	彐 冖 巾
帛	白 巾
帝	亠 丷 冖 巾
帞	巾 百
帟	亦 巾
帠	臼 巾
帢	巾 合
帣	丷 夫 巾	𠔉 巾
帤	如 巾
帥	戶 乛 一 巾	户 乛 一 巾
帨	巾 兌
帩	巾 肖
帪	巾 辰
師	戶 乛 一 帀	户 乛 一 帀
帬	尹 吊
席	广 廿 巾
帯	丗 冖 巾
帲	巾 幷
帳	巾 長
帴	巾 戔
帵	巾 宛
帶	廿 丿 乚 冖 巾
帷	巾 隹
常	尚 巾
帹	巾 妾
帺	巾 其
帽	巾 冒
帾	巾 者
帿	巾 侯
幀	巾 貞
幁	巾 頁
幃	巾 韋
幄	巾 屋
幅	巾 畐
幆	巾 曷
幇	封 巾
幈	巾 屏
幊	巾 貢
幋	般 巾
幌	巾 晃
幍	巾 舀
幎	巾 冥
幏	巾 家
幐	肉 丷 夫 巾	月 丷 夫 巾	肉 𠔉 巾	月 𠔉 巾
幑	彳 山 帀 攴	彳 山 帀 攵
幒	巾 悤
幓	巾 參
幔	巾 曼
幕	莫 巾
幖	巾 票
幗	巾 國
幘	巾 責
幙	巾 莫
幚	邦 巾
幛	巾 章
幜	巾 景
幝	巾 單
幞	巾 菐
幟	巾 戠
幠	巾 無
幡	巾 番
幢	巾 童
幣	敝 巾
幦	辟 巾
幧	巾 喿
幨	巾 詹
幩	巾 賁
幪	巾 蒙
幫	封 帛
幬	巾 壽
幭	巾 蔑
幮	巾 廚
幯	巾 節
幰	巾 憲
幱	巾 闌
干	一 十	二 丨
平	干 丷
年	丿 丰 丶	丿 一 二 丶 丨
幵	干 干	千 干
幸	土 丷 干	土 羊
幹	十 日 十 人 干
幻	幺 ㇆
幼	幺 力
幽	山 幺 幺
幾	幺 幺 戈 人	幺 幺 戍
庀	匕
庁	广 丁
庂	广 人
広	广 厶
庅	广 么
庇	广 比
庈	广 今
庉	广 屯
床	广 木
庋	广 支
庌	广 牙
庍	广 斤
庎	广 介
序	广 予
底	广 氐
庖	广 包
店	广 占
庘	广 甲
庚	广 彐 人	广 肀 人
庛	广 此
府	广 付
庝	广 冬
庠	广 羊
庡	广 衣
庢	广 至
庣	广 兆
庤	广 寺
庥	广 休
度	广 廿 又
座	广 坐
庨	广 孝
庩	广 余
庪	广 技
庫	广 車
庬	广 尨
庭	广 廷
庮	广 酉
庯	广 甫
庰	广 并	广 幷
庱	广 夌
庲	广 來
庳	广 卑
庴	广 昔
庵	广 奄
庶	广 廿 火	广 廿 灬
康	广 隶
庸	广 聿 冃	广 聿 冂 二	广 肀 冂 二	广 用 冂 二
庹	广 廿 尺
庺	广 枀
庻	广 廿 人 人
庽	广 禺
庾	广 臾
庿	广 苗
廀	广 叜
廁	广 則
廂	厂 相
廃	广 発
廄	广 艮 殳
廅	广 盍
廆	广 鬼
廇	广 留
廈	广 夏
廉	广 兼
廊	广 郎
廋	广 叟
廌	广 乛 一 丨 丨 ㇉ 火	广 乛 一 丨 丨 ㇉ 灬
廍	广 部
廎	广 頃
廏	广 白 匕 殳
廐	广 白 匕 旡
廑	广 堇
廒	广 敖
廓	广 郭
廔	广 婁
廕	广 陰
廖	广 翏
廗	广 帶
廘	广 鹿
廙	广 異
廚	广 尌	广 士 豆 寸
廛	广 里 儿 土
廜	广 屠
廝	厂 斯
廞	广 欽
廟	广 朝	广 由
廠	广 敞
廡	广 無
廢	广 發
廣	广 黃
廥	广 會
廦	广 辟
廧	广 嗇
廨	广 解
廩	广 稟
廫	广 膠
廬	广 盧
廮	广 嬰
廯	广 鮮
廰	广 聴
廱	广 雝
廲	广 麗
廳	广 聽
廵	廴 巛
延	廴 丿 止
廷	廴 壬
廸	廴 由
廹	廴 白
建	廴 聿
廻	廴 回
廼	廴 西
廽	廴 囬
廾	一 丿 丨
廿	一 凵
弁	厶 廾
弄	王 廾
弅	分 廾
弆	去 廾
弇	合 廾
弈	亦 廾
弉	壯 廾
弊	敝 廾
弋	一 乁 丶
弌	弋 一
弍	弋 二
弎	弋 三
式	弋 工
弐	一 弋 二
弒	杀 式
弓	㇆ 一 ㇉
弔	弓 丨
引	弓 丨
弖	弓 一
弗	弓 丿 丨
弘	弓 厶
弙	弓 于
弚	八 弔
弛	弓 也
弜	弓 弓
弝	弓 巴
弞	弓 欠
弟	丷 弔 丿	丷 弓 丨 丿
弡	弓 巨
弢	弓 山 又	弓 屮 又
弣	弓 付
弤	弓 氐
弦	弓 玄
弧	弓 瓜
弨	弓 召
弩	奴 弓
弫	弓 臣
弭	弓 耳
弮	丷 夫 弓	𠔉 弓
弰	弓 肖
弱	弓 冰 弓 冰	弓 冫 弓 冫
弲	弓 肙
弳	弓 巠
弴	弓 享
張	弓 長
弶	弓 京
強	弓 厶 蟲	弓 厶 虫
弸	弓 朋
弻	弓 丙 一 弓
弼	弓 百 弓
弽	弓 枼
弾	弓 単
弿	宀 井 大 弓
彀	士 冖 一 弓 殳
彂	业 矤
彃	弓 畢
彄	弓 區
彆	敝 弓
彇	弓 肅
彈	弓 單
彉	弓 黃
彊	弓 畺
彋	弓 睘
彌	弓 爾
彍	弓 廣
彎	絲 言 弓	糹 言 糹 弓	䜌 弓
彏	弓 矍
彔	彑 水
彖	彑 豕
彗	丰 丰 彐
彘	彑 比 矢	彑 匕 矢 匕
彙	彑 冖 果
彚	彐 冖 果
彜	彑 米 分 廾
彞	彐 米 糸 廾
彠	尋 蒦
彡	丿 丿 丿
形	开 彡
彣	丶 又 彡
彤	丹 彡
彥	文 厂 彡
彧	或 彡	或 丿 丿
彩	采 彡
彪	虎 彡
彫	周 彡
彬	林 彡
彭	壴 彡
彮	容 彡
彯	票 彡
彰	章 彡
影	景 彡
彲	麗 彡
彳	丿 人	丿 亻
彴	彳 勺
彵	彳 也
彶	彳 及
彷	彳 方
彸	彳 公
役	彳 殳
彺	彳 王
彼	彳 皮
彽	彳 氐
彾	彳 令
彿	彳 弗
往	彳 主
征	彳 正
徂	彳 且
徃	彳 生
待	彳 寺
徆	彳 西
徇	彳 旬
很	彳 艮
徉	彳 羊
徊	彳 回
律	彳 聿
後	彳 幺 夂	彳 幺 夕
徍	彳 圭
徎	彳 呈
徏	彳 步
徐	彳 余
徑	彳 巠
徒	彳 走
従	彳 丷 一 卜 人 	彳 丷 下 人 
徖	彳 宗
得	彳 日 一 寸	彳 㝵
徘	彳 非
徙	彳 歨	彳 止 疋
徛	彳 奇
徜	彳 尚
徝	彳 直
從	彳 人 人 疋
徟	彳 周
徠	彳 來
御	彳 卸
徢	彳 疌
徣	彳 昔
徤	彳 建
徥	彳 是
徦	彳 叚
徧	彳 扁
徨	彳 皇
復	彳 复
循	彳 盾
徫	彳 韋
徬	彳 旁
徭	彳 月 缶	彳 䍃
微	彳 山 兀 攴	彳 山 兀 攵
徯	彳 奚
徰	彳 正 正
徱	彳 票
徲	彳 犀
徳	彳 十 目 心	彳 十 网 心	彳 十 罒 心
徴	彳 山 王 攴	彳 山 王 攵
徵	彳 山 一 王 攴	彳 山 一 王 攵
徶	彳 敝
德	彳 十 网 一 心	彳 十 罒 一 心
徸	彳 童
徹	彳 育 攵
徺	彳 堯
徻	彳 會
徼	彳 敫
徽	彳 山 糸 攴	彳 山 糸 攵
徾	彳 山 一 言 攴	彳 山 一 言 攵
徿	彳 龍
忀	彳 襄
忁	彳 日 出 大 水
忂	彳 瞿
心	丿 乚 丶 丶
必	心 丿
忇	心 力	忄 力
忈	二 心
忉	心 刀	忄 刀
忊	心 丁	忄 丁
忋	心 己	忄 己
忌	己 心
忍	刃 心
忎	千 心
忐	上 心
忑	下 心
忒	弋 心
忓	心 干	忄 干
忔	心 乞	忄 乞
忕	心 大	忄 大
忖	心 寸	忄 寸
志	士 心
忘	亡 心
忙	心 亡	忄 亡
忚	心 也	忄 也
忛	心 凡	忄 凡
応	广 心
忝	天 心
忞	文 心
忟	心 文	忄 文
忠	中 心
忡	心 中	忄 中
忢	五 心
忣	心 及	忄 及
忤	心 午	忄 午
忥	氣 心	气 心
忦	心 介	忄 介
忨	心 元	忄 元
忩	公 心
忪	心 公	忄 公
快	心 夬	忄 夬
忬	心 予	忄 予
忭	心 卞	忄 卞
忮	心 支	忄 支
忯	心 氐	忄 氐
忰	心 卆	忄 卆
忱	心 冘	忄 冘
忲	心 太	忄 太
忳	心 屯	忄 屯
忴	心 今	忄 今
念	今 心
忶	心 云	忄 云
忷	心 凶	忄 凶
忸	心 丑	忄 丑
忹	心 王	忄 王
忺	心 欠	忄 欠
忻	心 斤	忄 斤
忼	心 亢	忄 亢
忽	勿 心
忿	分 心
怇	心 巨	忄 巨
怈	心 世	忄 世
怉	心 包	忄 包
怊	心 召	忄 召
怋	心 民	忄 民
怌	心 丕	忄 丕
怍	心 乍	忄 乍
怎	乍 心
怏	心 央	忄 央
怐	心 句	忄 句
怑	心 半	忄 半
怒	奴 心
怓	心 奴	忄 奴
怔	心 正	忄 正
怕	心 白	忄 白
怖	心 布	忄 布
怗	心 占	忄 占
怘	古 心
怙	心 古	忄 古
怚	心 且	忄 且
怛	心 旦	忄 旦
思	田 心
怞	心 由	忄 由
怟	心 氐	忄 氐
怠	台 心
怡	心 台	忄 台
怢	心 失	忄 失
怣	失 心
怤	付 心
急	刍 心
怦	心 平	忄 平
性	心 生	忄 生
怨	夗 心	夕 卩 心	夕 㔾 心
怩	心 尼	忄 尼
怪	心 圣	忄 圣
怫	心 弗	忄 弗
怬	心 四	忄 四
怭	心 必	忄 必
怮	心 幼	忄 幼
怯	心 去	忄 去
怰	心 玄	忄 玄
怱	匆 心
怲	心 丙	忄 丙
怳	心 兄	忄 兄
怴	心 戉	忄 戉
怵	心 术	忄 术
怶	心 皮	忄 皮
怷	朮 心
怸	术 心
怹	他 心
恀	心 多	忄 多
恁	任 心
恂	心 旬	忄 旬
恃	心 寺	忄 寺
恄	心 吉	忄 吉
恅	心 老	忄 老
恆	心 亙	忄 亙
恇	心 匡	忄 匡
恈	心 牟	忄 牟
恉	心 旨	忄 旨
恊	心 劦	忄 劦
恌	心 兆	忄 兆
恍	心 光	忄 光
恎	心 至	忄 至
恏	好 心
恐	巩 心	工 凡 心
恑	心 危	忄 危
恓	心 西	忄 西
恔	心 交	忄 交
恕	女 口 心
恗	心 夸	忄 夸
恘	心 休	忄 休
恙	羊 心
恚	圭 心
恛	心 回	忄 回
恜	心 式	忄 式
恝	丰 刀 心
恞	心 夷	忄 夷
恟	心 匈	忄 匈
恠	心 在	忄 在
恡	心 乂 厷	忄 乂 厷
恢	心 灰	忄 灰
恣	次 心
恤	心 血	忄 血
恥	耳 心
恦	心 向	忄 向
恧	而 心
恨	心 艮	忄 艮
恩	因 心
恪	心 各	忄 各
恫	心 同	忄 同
恬	心 舌	忄 舌
恭	共 心	共 小 丶
恮	心 全	忄 全
息	自 心
恰	心 合	忄 合
恱	心 兊	忄 兊
恲	心 并	忄 并	心 幷	忄 幷
恴	亠 日 心
恵	一 由 心
恾	心 芒	忄 芒
悀	心 甬	忄 甬
悁	心 肙	忄 肙
悂	心 坒	忄 坒
悃	心 困	忄 困
悄	心 肖	忄 肖
悅	心 兌	忄 兌
悆	余 心
悇	心 余	忄 余
悈	心 戒	忄 戒
悉	采 心	釆 心
悊	折 心
悋	心 吝	忄 吝
悌	心 弟	忄 弟
悍	心 旱	忄 旱
悎	心 告	忄 告
悏	心 夾	忄 夾
悐	狄 心
悑	心 甫	忄 甫
悒	心 邑	忄 邑
悓	心 見	忄 見
悔	心 每	忄 每
悕	心 希	忄 希
悖	心 孛	忄 孛
悗	心 免	忄 免
悘	医 心
悙	心 亨	忄 亨
悚	心 束	忄 束
悛	心 夋	忄 夋
悜	心 呈	忄 呈
悝	心 里	忄 里
悞	心 吳	忄 吳
悟	心 吾	忄 吾
悠	攸 心
悡	利 心
悢	心 良	忄 良
患	串 心
悤	囱 心
悥	言 心
悧	心 利	忄 利
您	你 心
悩	心 小 乂 凵	忄 小 乂 凵
悪	亜 心
悰	心 宗	忄 宗
悱	心 非	忄 非
悲	非 心
悳	直 心
悴	心 卒	忄 卒
悵	心 長	忄 長
悶	門 心
悷	心 戾	忄 戾
悸	心 季	忄 季
悹	官 心
悺	心 官	忄 官
悻	心 幸	忄 幸
悼	心 卓	忄 卓
悽	心 妻	忄 妻
悾	心 空	忄 空
悿	心 忝	忄 忝
惀	心 侖	忄 侖
惁	析 心
惂	心 臽	忄 臽
惃	心 昆	忄 昆
惄	叔 心
情	心 青	忄 青
惆	心 周	忄 周
惇	心 享	忄 享
惈	心 果	忄 果
惉	沾 心
惋	心 宛	忄 宛
惌	宛 心	宀 怨
惍	心 金	忄 金
惎	其 心
惏	心 林	忄 林
惐	心 或	忄 或
惑	或 心
惒	和 心
惓	心 卷	忄 卷
惔	心 炎	忄 炎
惕	心 易	忄 易
惖	易 心
惗	心 念	忄 念
惘	心 罔	忄 罔
惙	心 叕	忄 叕
惚	心 忽	忄 忽
惛	心 昏	忄 昏
惜	心 昔	忄 昔
惝	心 尚	忄 尚
惞	心 欣	忄 欣
惟	心 隹	忄 隹
惠	叀 心	一 由 厶 心
惡	亞 心
惢	心 心 心
惣	物 心
惤	心 弦	忄 弦
惥	臾 心
惦	心 店	忄 店
惪	直 心
惰	心 左 肉	忄 左 月
惱	心 巛 囟	忄 巛 囟	心 𡿺	忄 𡿺
惲	心 軍	忄 軍
想	相 心
惴	心 耑	忄 耑	心 山 而	忄 山 而
惵	心 枼	忄 枼
惶	心 皇	忄 皇
惷	春 心
惸	心 旬 子	忄 旬 子
惹	若 心
惺	心 星	忄 星
惻	心 則	忄 則
惼	心 扁	忄 扁
惽	心 昬	忄 昬
惾	心 凶 八 夕	忄 凶 八 夂
惿	心 是	忄 是
愀	心 秋	忄 秋
愁	秋 心
愂	勃 心
愃	心 宣	忄 宣
愄	心 畏	忄 畏
愅	心 革	忄 革
愆	衍 心
愇	心 韋	忄 韋
愈	俞 心
愉	心 俞	忄 俞
愊	心 畐	忄 畐
愋	心 爰	忄 爰
愌	心 奐	忄 奐
愍	敃 心
愎	心 复	忄 复
意	音 心
愐	心 面	忄 面
愑	心 勇	忄 勇
愒	心 曷	忄 曷
愓	心 昜	忄 昜
愔	心 音	忄 音
愕	心 咢	忄 咢
愖	心 甚	忄 甚
愗	敄 心
愘	心 客	忄 客
愙	客 心
愚	禺 心
愛	爪 冖 心 夂	爫 冖 心 夂
愜	心 匧	忄 匧
愝	心 匽	忄 匽
愞	心 耎	忄 耎
感	咸 心
愡	心 怱	忄 怱
愢	心 思	忄 思
愣	心 网 方	忄 罒 方
愧	心 鬼	忄 鬼
愨	士 冖 一 殳 心
愩	心 貢	忄 貢
愪	心 員	忄 員
愫	心 素	忄 素
愬	朔 心
愭	心 耆	忄 耆
愮	心 月 缶	忄 月 缶	心 䍃	忄 䍃
愯	心 隻	忄 隻
愰	心 晃	忄 晃
愱	心 疾	忄 疾
愲	心 骨	忄 骨
愳	目 目 心
愴	心 倉	忄 倉
愵	心 弱	忄 弱
愶	心 脅	忄 脅
愷	心 豈	忄 豈
愸	勑 心
愹	心 容	忄 容
愺	心 草	忄 草
愻	孫 心
愼	心 眞	忄 眞
愽	心 尃	忄 尃
愾	心 氣	忄 氣
慀	心 奚	忄 奚
慁	圂 心
慂	涌 心
慃	心 翁	忄 翁
慄	心 栗	忄 栗
慅	心 蚤	忄 蚤
慆	心 舀	忄 舀
慇	殷 心
慈	茲 心
慉	心 畜	忄 畜
慊	心 丶 丶 兼	忄 丶 丶 兼
態	能 心
慌	心 荒	忄 荒
慍	心 囚 皿	忄 囚 皿
慎	心 真	忄 真
慏	心 冥	忄 冥
慒	心 曹	忄 曹
慓	心 票	忄 票
慔	心 莫	忄 莫
慕	莫 心	莫 小 丶
慖	心 國	忄 國
慗	敕 心
慘	心 參	忄 參
慙	斬 心
慚	心 斬	忄 斬
慛	心 崔	忄 崔
慜	敏 心
慝	匿 心
慞	心 章	忄 章
慟	心 動	忄 動
慠	心 敖	忄 敖
慡	心 爽	忄 爽
慢	心 曼	忄 曼
慣	心 貫	忄 貫
慤	壳 殳 心	殼 心
慥	心 造	忄 造
慦	救 心
慧	彗 心
慨	心 既	忄 既
慩	心 連	忄 連
慪	心 區	忄 區
慫	從 心
慬	心 堇	忄 堇
慮	虎 思 心	虍 思 心
慯	心 丿 一 昜	忄 丿 一 昜
慰	尉 心
慱	心 專	忄 專
慲	心 廿 冂 丨 入 入	忄 廿 冂 丨 入 入	心 㒼	忄 㒼
慳	心 堅	忄 堅
慴	心 習	忄 習
慵	心 庸	忄 庸
慶	广 乛 一 丨 丨 乛 心 夕	广 乛 一 丨 丨 乛 心 夂
慷	心 康	忄 康
慸	帶 心
慹	執 心
慺	心 婁	忄 婁
慻	心 丷 夫 目	忄 丷 夫 目	心 𠔉 目	忄 𠔉 目
慼	戚 心
慽	心 戚	忄 戚
慾	欲 心
憀	心 翏	忄 翏
憁	心 悤	忄 悤
憂	一 白 冖 心 夕	一 白 冖 心 夂
憃	舂 心
憄	徝 心
憅	動 心
憆	心 堂	忄 堂
憇	甜 心
憈	心 虛	忄 虛
憉	心 彭	忄 彭
憊	備 心
憋	敝 心
憌	鈞 心
憍	心 喬	忄 喬
憎	心 曽	忄 曽	心 曾	忄 曾
憏	心 祭	忄 祭
憐	心 粦	忄 粦
憑	馮 心
憒	心 貴	忄 貴
憓	心 惠	忄 惠
憔	心 焦	忄 焦
憕	心 登	忄 登
憖	猌 心
憗	心 來 攴	來 攵
憘	心 喜	忄 喜
憙	喜 心
憚	心 單	忄 單
憛	心 覃	忄 覃
憜	心 隋	忄 隋
憝	敦 心
憞	心 敦	忄 敦
憟	心 粟	忄 粟
憠	厥 心
憡	心 策	忄 策
憢	心 堯	忄 堯
憣	心 番	忄 番
憤	心 賁	忄 賁	心 十 十 十 貝	忄 十 十 十 貝
憥	勞 心
憦	心 勞	忄 勞
憧	心 童	忄 童
憨	敢 心
憩	舌 自 心
憪	心 閒	忄 閒
憫	心 閔	忄 閔
憬	心 景	忄 景
憭	心 尞	忄 尞
憮	心 無	忄 無
憯	心 朁	忄 朁
憰	心 矞	忄 矞
憱	心 就	忄 就
憲	宀 丰 网 心	宀 丰 罒 心
憳	心 尋	忄 尋
憴	心 黽	忄 黽
憵	辟 心
憶	心 意	忄 意
憷	心 楚	忄 楚
憸	心 僉	忄 僉
憹	心 農	忄 農
憺	心 詹	忄 詹
憻	心 亶	忄 亶
憼	敬 心
憽	心 葱	忄 葱
憾	心 感	忄 感
憿	心 敫	忄 敫
懀	心 會	忄 會
懁	心 睘	忄 睘
懂	心 董	忄 董
懃	勤 心
懄	心 勤	忄 勤
懅	心 豦	忄 豦
懆	心 喿	忄 喿
懇	豸 艮 心
懈	心 解	忄 解
應	广 人 隹 心	广 亻 隹 心	广 倠 心
懊	心 奧
懋	楙 心
懌	心 睪	忄 睪
懍	心 稟	忄 稟
懎	心 嗇	忄 嗇
懏	心 雋	忄 雋
懐	心 十 目 衣	忄 十 网 衣	忄 十 罒 衣
懓	心 愛	忄 愛
懕	厭 心
懖	銛 心
懗	心 赫	忄 赫
懘	滯 心
懙	心 與	忄 與
懚	心 爪 工 彐 心	忄 爫 工 彐 心	心 㥯	忄 㥯
懛	心 臺	忄 臺
懜	心 夢	忄 夢
懝	心 疑	忄 疑
懞	心 蒙	忄 蒙
懟	對 心
懠	心 齊	忄 齊
懡	心 麽	忄 麽
懢	心 監	忄 監
懣	滿 心
懤	心 壽	忄 壽
懥	心 疐	忄 疐
懦	心 需	忄 需
懧	心 寧	忄 寧
懨	心 厭	忄 厭
懩	心 養	忄 養
懪	心 暴	忄 暴
懫	心 質	忄 質
懬	廣 心
懭	心 廣	忄 廣
懮	心 憂	忄 憂
懯	敷 心
懰	心 劉	忄 劉
懱	心 蔑	忄 蔑
懲	徴 心
懴	心 韯	忄 韯
懵	心 瞢	忄 瞢
懶	心 賴	忄 賴
懷	心 褱	忄 褱
懸	縣 心
懹	心 襄	忄 襄
懺	心 韱	忄 韱
懻	心 冀	忄 冀
懼	心 瞿	忄 瞿
懽	心 雚	忄 雚
懾	心 聶	忄 聶
懿	壹 恣
戀	絲 言 心	糸 言 糸 心	䜌 心
戁	難 心
戂	心 靡	忄 靡
戃	心 黨	忄 黨
戄	心 矍	忄 矍
戅	贑 心
戇	立 早 攴 頁 心	立 早 攵 頁 心
戈	一 乁 丿 丶
戊	丿 戈
戌	戊 一
戍	戊 丶
戎	十 戈	一 十 戈
成	戊 ㇆
我	手 戈	扌 戈	才 戈
戒	廾 戈
戓	戈 口
戔	戈 戈
戕	爿 戈
或	口 一 戈
戙	同 戈
戚	厂 上 小 戈	丿 上 小 戈
戛	一 自 戈
戜	戈 呈
戝	貝 戈
戞	百 冖 戈
戟	十 早 戈
戠	音 戈
戡	甚 戈
戢	口 耳 戈
戣	癸 戈
戤	盈 戈
戥	星 戈
戦	单 丶 戈
戧	倉 戈
戨	哥 戈
戩	晉 戈
截	十 戈 隹	土 戈 隹	𢦏 隹
戫	有 或
戭	寅 戈
戮	翏 戈
戰	單 戈
戱	虛 戈
戲	虎 豆 戈	虍 豆 戈
戳	翟 戈	羽 隹 戈
戴	十 戈 異	土 戈 異	𢦏 異
戵	瞿 戈
戶	丿 尸	一 尸 戸
戸	一 尸
戹	戶 乙
戺	戶 巳
戻	戶 大
戼	㇆ 匸 戶
戽	戶 斗
戾	户 大
房	戶 方	户 方	戸 方
所	戶 斤	户 斤	戸 斤
扁	戶 冊	户 冊	戸 冊
扂	戶 占
扃	戶 冋
扄	戶 向
扅	戶 多
扆	戶 衣
扇	戶 羽	户 羽	戸 羽
扈	戶 邑	户 邑	戸 邑
扉	戶 非
扊	戶 炎
手	丿 二 亅
扌	一 亅 丿
才	一 亅 丿
扎	手 乚	扌 乚	才 乚
扏	手 九	扌 九	才 九
扐	手 力	扌 力	才 力
扒	手 八	扌 八	才 八
打	手 丁	扌 丁	才 丁
扔	手 乃	扌 乃	才 乃
払	手 厶	扌 厶	才 厶
扗	手 土	扌 土	才 土
托	手 乇	扌 乇	才 乇
扙	手 丈	扌 丈	才 丈
扚	手 勺	扌 勺	才 勺
扛	手 工	扌 工	才 工
扜	手 于	扌 于	才 于
扝	手 亏	扌 亏	才 亏
扞	手 干	扌 干	才 干
扟	手 卂	扌 卂	才 卂
扠	手 叉	扌 叉	才 叉
扡	手 也	扌 也	才 也
扢	手 乞	扌 乞	才 乞
扣	手 口	扌 口	才 口
扤	手 兀	扌 兀	才 兀
扥	手 丿 一 乚	扌 丿 一 乚	才 丿 一 乚
扦	手 千	扌 千	才 千
扨	手 刄	扌 刄	才 刄	手 刃
扭	手 丑	扌 丑	才 丑
扮	手 分	扌 分
扯	手 止	扌 止	才 止
扱	手 及	扌 及	才 及
扲	手 今	扌 今	才 今
扳	手 反	扌 反
扴	手 介	扌 介	才 介
扵	手 仒	扌 仒	才 仒
扶	手 夫	扌 夫	才 夫
扸	手 片	扌 片	才 片
批	手 比	扌 比	才 比
扺	手 氏	扌 氏	才 氏
扻	手 欠	扌 欠	才 欠
扼	手 厄	扌 厄	才 厄
扽	手 屯	扌 屯	才 屯
找	手 戈	扌 戈	才 戈
承	氶 三
技	手 支	扌 支	才 支
抁	手 允	扌 允	才 允
抂	手 王	扌 王	才 王
抃	手 卞	扌 卞	才 卞
抄	手 少	扌 少	才 少
抅	手 勾	扌 勾	才 勾
抆	手 文	扌 文	才 文
抇	手 日	扌 日	才 日
抈	手 月	扌 月	才 月
抉	手 夬	扌 夬	才 夬
把	手 巴	扌 巴
抋	手 心	扌 心	才 心
抌	手 冘	扌 冘	才 冘
抍	手 升	扌 升	才 升
抎	手 云	扌 云	才 云
抏	手 元	扌 元	才 元
抐	手 內	扌 內	才 內
抑	手 卬	扌 卬	才 卬
抒	手 予	扌 予	才 予
抓	手 爪	扌 爪	才 爪
抔	手 不	扌 不	才 不
投	手 殳	扌 殳	才 殳
抖	手 斗	扌 斗	才 斗
抗	手 亢	扌 亢	才 亢
折	手 斤	扌 斤	才 斤
抙	手 手	扌 手
抜	手 友	扌 友	才 友
抝	手 幻	扌 幻	才 幻
択	手 尺	扌 尺	才 尺
抦	手 丙	扌 丙	才 丙
抧	手 只	扌 只	才 只
抨	手 平	扌 平	才 平
抩	手 冉	扌 冉	才 冉
抪	手 布	扌 布	才 布
披	手 皮	扌 皮	才 皮
抬	手 台	扌 台	才 台
抭	手 宀 儿	扌 宀 儿	才 宀 儿
抮	手 人 彡	扌 人 彡	才 人 彡
抯	手 且	扌 且	才 且
抰	手 央	扌 央	才 央
抱	手 包	扌 包
抲	手 可	扌 可	才 可
抳	手 尼	扌 尼	才 尼
抴	手 世	扌 世	才 世
抵	手 氐	扌 氐	才 氐	手 氏 丶
抶	手 失	扌 失	才 失
抷	手 丕	扌 丕	才 丕
抸	手 乏	扌 乏	才 乏
抹	手 末	扌 末	才 末
抺	手 未	扌 未	才 未
抻	手 申	扌 申	才 申
押	手 甲	扌 甲	才 甲
抽	手 由	扌 由	才 由
抾	手 去	扌 去	才 去
抿	手 民	扌 民	才 民
拀	手 兄	扌 兄	才 兄
拁	手 加	扌 加	才 加
拂	手 弗	扌 弗	才 弗
拃	手 乍	扌 乍	才 乍
拄	手 主	扌 主	才 主
拆	手 斥	扌 斥	才 斥
拇	手 母	扌 母	才 母
拈	手 占	扌 占	才 占
拉	手 立	扌 立	才 立
拊	手 付	扌 付	才 付
拋	手 尢 力	扌 尢 力	才 尢 力
拌	手 半	扌 半
拍	手 白	扌 白	才 白
拎	手 令	扌 令	才 令
拏	奴 手
拐	手 口 刀	扌 口 刀	才 口 刀	手 另
拑	手 甘	扌 甘	才 甘
拒	手 巨	扌 巨	才 巨
拓	手 石	扌 石	才 石
拔	手 犮	扌 犮	才 犮
拕	手 它	扌 它	才 它
拖	手 丿 一 也	扌 丿 一 也	才 丿 一 也
拗	手 幼	扌 幼	才 幼
拘	手 句	扌 句	才 句
拙	手 出	扌 出	才 出
拚	手 厶 廾	扌 厶 廾	才 厶 廾
招	手 召	扌 召	才 召
拜	手 手
拝	手 手	扌 手	才 手
拞	手 丘	扌 丘	才 丘
拠	手 処	扌 処	才 処
拡	手 広	扌 広	才 広
拪	手 西	扌 西	才 西
拫	手 艮	扌 艮	才 艮
括	手 舌	扌 舌	才 舌
拭	手 式	扌 式	才 式
拮	手 吉	扌 吉	才 吉
拯	手 丞	扌 丞	才 丞
拰	手 任	扌 任	才 任
拱	手 共	扌 共	才 共
拲	共 手
拳	丷 夫 手	𠔉 手
拴	手 全	扌 全	才 全
拵	手 存	扌 存	才 存
拶	手 巛 夕	扌 巛 夕	才 巛 夕
拷	手 考	扌 考	才 考
拸	手 多	扌 多	才 多
拹	手 劦	扌 劦	才 劦
拺	手 朿	扌 朿	才 朿
拻	手 灰	扌 灰	才 灰
拼	手 并	扌 并	才 并	手 幷	扌 幷	才 幷
拽	手 曳	扌 曳	才 曳
拾	手 合	扌 合	才 合
拿	合 手
挀	手 厂 氏	扌 厂 氏	才 厂 氏	手 𠂢	扌 𠂢	才 𠂢
持	手 寺	扌 寺	才 寺
挃	手 至	扌 至	才 至
挄	手 光	扌 光	才 光
挅	手 朶	扌 朶	才 朶
挆	手 朵	扌 朵	才 朵
指	手 旨	扌 旨	才 旨
挈	丰 刀 手
按	手 安	扌 安	才 安
挊	手 上 下	扌 上 下	才 上 下
挋	手 臣	扌 臣	才 臣
挌	手 各	扌 各	才 各
挍	手 交	扌 交	才 交
挎	手 夸	扌 夸	才 夸
挏	手 同	扌 同	才 同
挐	如 手
挑	手 兆	扌 兆	才 兆
挒	手 列	扌 列	才 列
挓	手 宅	扌 宅	才 宅
挔	手 衣	扌 衣	才 衣
挕	手 耳	扌 耳	才 耳
挖	手 穵	扌 穵	才 穵	手 穴 乙
挗	手 夷	扌 夷	才 夷
挨	手 矣	扌 矣	才 矣
挩	手 兌	扌 兌	才 兌
挪	手 那	扌 那	才 那
挫	手 坐	扌 坐	才 坐
挬	手 孛	扌 孛	才 孛
挭	手 更	扌 更	才 更
挮	手 弟	扌 弟	才 弟
振	手 辰	扌 辰	才 辰
挰	手 呈	扌 呈	才 呈
挱	手 沙	扌 沙	才 沙
挲	沙 手
挳	手 巠	扌 巠	才 巠
挴	手 每	扌 每	才 每
挵	手 弄	扌 弄	才 弄
挶	手 局	扌 局	才 局
挷	手 邦	扌 邦	才 邦
挸	手 見	扌 見	才 見
挹	手 邑	扌 邑	才 邑
挺	手 廷	扌 廷	才 廷
挻	手 延	扌 延	才 延
挼	手 妥	扌 妥	才 妥
挽	手 免	扌 免	才 免
挾	手 夾	扌 夾	才 夾
捀	手 夆	扌 夆	才 夆
捁	手 告	扌 告	才 告
捃	手 君	扌 君	才 君
捄	手 求	扌 求	才 求
捅	手 甬	扌 甬	才 甬
捆	手 困	扌 困	才 困
捇	手 赤	扌 赤	才 赤
捈	手 余	扌 余	才 余
捉	手 足	扌 足	才 足
捊	手 孚	扌 孚	才 孚
捋	手 寽	扌 寽	才 寽	手 爪 寸	扌 爫 寸
捌	手 別	扌 別	才 別
捍	手 旱	扌 旱	才 旱
捎	手 肖	扌 肖	才 肖
捏	手 圼	扌 圼	才 圼
捐	手 肙	扌 肙	才 肙	手 口 月
捑	手 日 夨	扌 日 夨	才 日 夨
捒	手 束	扌 束	才 束
捓	手 邪	扌 邪	才 邪
捔	手 角	扌 角	才 角
捕	手 甫	扌 甫	才 甫
捖	手 完	扌 完	才 完
捗	手 步	扌 步	才 步
捘	手 夋	扌 夋	才 夋
捙	手 車	扌 車	才 車
捚	手 里	扌 里	才 里
捛	手 呂	扌 呂	才 呂
捜	手 叟	扌 叟	才 叟
捠	手 兵	扌 兵	才 兵
捥	手 宛	扌 宛	才 宛
捦	手 金	扌 金	才 金
捧	手 奉	扌 奉	才 奉
捨	手 舍	扌 舍	才 舍
捩	手 戾	扌 戾	才 戾	手 戶 犬	手 户 犬
捪	手 昏	扌 昏	才 昏
捫	手 門	扌 門	才 門
捬	手 府	扌 府	才 府
捭	手 卑	扌 卑	才 卑
据	手 居	扌 居	才 居
捯	手 到	扌 到	才 到
捰	手 果	扌 果	才 果
捱	手 厓	扌 厓	才 厓
捲	手 卷	扌 卷	才 卷
捳	手 岳	扌 岳	才 岳
捴	手 忩	扌 忩	才 忩
捵	手 典	扌 典	才 典
捶	手 垂	扌 垂	才 垂
捷	手 疌	扌 疌	才 疌
捸	手 隶	扌 隶	才 隶
捹	手 奔	扌 奔	才 奔
捺	手 奈	扌 奈	才 奈
捻	手 念	扌 念	才 念
捼	手 委	扌 委	才 委
捽	手 卒	扌 卒	才 卒
捾	手 官	扌 官	才 官
捿	手 妻	扌 妻	才 妻
掀	手 欣	扌 欣	才 欣
掁	手 長	扌 長	才 長
掂	手 店	扌 店	才 店
掃	手 帚	扌 帚	才 帚
掄	手 侖	扌 侖	才 侖
掅	手 青	扌 青	才 青
掆	手 岡	扌 岡	才 岡
掇	手 叕	扌 叕	才 叕
授	手 受	扌 受	才 受
掉	手 卓	扌 卓	才 卓
掊	手 咅	扌 咅	才 咅
掋	手 底	扌 底	才 底
掌	尚 口 手
掍	手 昆	扌 昆	才 昆
掎	手 奇	扌 奇	才 奇
掏	手 匋	扌 匋	才 匋
掐	手 臽	扌 臽	才 臽
掑	手 其	扌 其	才 其
排	手 非	扌 非	才 非
掓	手 叔	扌 叔	才 叔
掔	臣 又 手
掕	手 夌	扌 夌	才 夌
掖	手 夜	扌 夜	才 夜
掗	手 亞	扌 亞	才 亞
掘	手 屈	扌 屈	才 屈
掙	手 爭	扌 爭	才 爭
掚	手 兩	扌 兩	才 兩
掛	手 卦	扌 卦	才 卦
掜	手 兒	扌 兒	才 兒
掝	手 或	扌 或	才 或
掞	手 炎	扌 炎	才 炎
掟	手 定	扌 定	才 定
掠	手 京	扌 京	才 京
採	手 采	扌 采	才 采
探	手 罙	扌 罙	才 罙
掣	制 手
掤	手 朋	扌 朋	才 朋
接	手 妾	扌 妾	才 妾
掦	手 易	扌 易	才 易
控	手 空	扌 空	才 空
推	手 隹	扌 隹	才 隹
掩	手 奄	扌 奄	才 奄
措	手 昔	扌 昔	才 昔
掫	手 取	扌 取	才 取
掬	手 匊	扌 匊	才 匊	手 勹 米
掭	手 忝	扌 忝	才 忝
掮	手 肩	扌 肩	才 肩
掯	手 肯	扌 肯	才 肯
掰	手 分 手
掱	手 手 手
掲	手 日 勹 匕	扌 日 勹 匕	才 日 勹 匕
掹	手 孟	扌 孟	才 孟
掻	手 又 蟲	扌 又 虫	才 又 虫
掽	手 並	扌 並	才 並
掾	手 彖	扌 彖	才 彖
掿	手 若	扌 若	才 若
揀	手 柬	扌 柬	才 柬
揁	手 貞	扌 貞	才 貞
揂	手 酋	扌 酋	才 酋
揃	手 前	扌 前	才 前
揄	手 俞	扌 俞	才 俞
揅	研 手
揆	手 癸	扌 癸	才 癸
揇	手 南	扌 南	才 南
揈	手 訇	扌 訇	才 訇
揉	手 柔	扌 柔	才 柔
揊	手 畐	扌 畐	才 畐
揋	手 畏	扌 畏	才 畏
揌	手 思	扌 思	才 思
揍	手 奏	扌 奏	才 奏
揎	手 宣	扌 宣	才 宣
描	手 苗	扌 苗	才 苗
提	手 是	扌 是	才 是
揑	手 臼 工	扌 臼 工	才 臼 工
插	手 臿	扌 臿	才 臿	手 千 臼
揓	手 施	扌 施	才 施
揔	手 怱	扌 怱	才 怱
揕	手 甚	扌 甚	才 甚
揖	手 咠	扌 咠	才 咠	手 口 耳
揗	手 盾	扌 盾	才 盾
揘	手 皇	扌 皇	才 皇
揙	手 扁	扌 扁	才 扁
揚	手 昜	扌 昜	才 昜
換	手 奐	扌 奐	才 奐
揜	手 弇	扌 弇	才 弇
揝	手 昝	扌 昝	才 昝
揞	手 音	扌 音	才 音
揟	手 胥	扌 胥	才 胥
揠	手 匽	扌 匽	才 匽
握	手 屋	扌 屋	才 屋
揢	手 客	扌 客	才 客
揣	手 耑	扌 耑	才 耑
揤	手 即	扌 即	才 即
揥	手 帝	扌 帝	才 帝
揦	手 剌	扌 剌	才 剌
揧	剌 手
揨	手 亭	扌 亭	才 亭
揩	手 皆	扌 皆	才 皆
揪	手 秋	扌 秋	才 秋
揫	秋 手
揬	手 突	扌 突	才 突
揭	手 曷	扌 曷	才 曷
揮	手 軍	扌 軍	才 軍
揯	手 恆	扌 恆	才 恆
揰	手 重	扌 重	才 重
揱	削 手
揲	手 枼	扌 枼	才 枼
揳	手 契	扌 契	才 契
援	手 爰	扌 爰	才 爰
揵	手 建	扌 建	才 建
揶	手 耶	扌 耶	才 耶
揷	手 千 臼	扌 千 臼	才 千 臼
揸	手 查	扌 查	才 查
揹	手 背	扌 背	才 背
揺	手 爪 击	扌 爫 击	才 爫 击
揼	手 泵	扌 泵	才 泵
搆	手 冓	扌 冓	才 冓
搇	手 衾	扌 衾	才 衾
搈	手 容	扌 容	才 容
搉	手 隺	扌 隺	才 隺
搊	手 芻	扌 芻	才 芻
搋	手 虒	扌 虒	才 虒
搌	手 展	扌 展	才 展
損	手 員	扌 員	才 員
搎	手 孫	扌 孫	才 孫
搏	手 尃	扌 尃	才 尃	手 甫 寸
搐	手 畜	扌 畜	才 畜
搑	手 茸	扌 茸	才 茸
搒	手 旁	扌 旁	才 旁
搓	手 差	扌 差	才 差
搔	手 蚤	扌 蚤	才 蚤
搕	手 盍	扌 盍	才 盍
搖	手 月 缶	扌 月 缶	才 月 缶	手 䍃	扌 䍃	才 䍃
搗	手 島	扌 島	才 島
搘	手 耆	扌 耆	才 耆
搙	手 辱	扌 辱	才 辱
搚	手 脅	扌 脅	才 脅
搛	手 兼	扌 兼	才 兼
搜	手 叟	扌 叟	才 叟
搝	手 臭	扌 臭	才 臭
搞	手 高	扌 高	才 高
搟	手 軒	扌 軒	才 軒
搠	手 朔	扌 朔	才 朔
搡	手 桑	扌 桑	才 桑
搢	手 晉	扌 晉	才 晉
搣	手 烕	扌 烕	才 烕
搤	手 益	扌 益	才 益
搥	手 追	扌 追	才 追
搦	手 弱	扌 弱	才 弱
搧	手 扇	扌 扇	才 扇
搨	手 日 羽	扌 日 羽	才 日 羽
搪	手 唐	扌 唐	才 唐
搫	般 手
搬	手 般	扌 般	才 般
搭	手 荅	扌 荅	才 荅
搮	手 栗	扌 栗	才 栗
搯	手 舀	扌 舀	才 舀
搰	手 骨	扌 骨	才 骨
搱	手 屖	扌 屖	才 屖
搲	手 穴 瓜	扌 窊	才 窊
搳	手 害	扌 害	才 害
搴	宀 井 大 手
搵	手 昷	扌 昷	才 昷
搶	手 倉	扌 倉	才 倉
搷	手 真	扌 真	才 真
搸	手 秦	扌 秦	才 秦
搹	手 鬲	扌 鬲	才 鬲
搻	合 手 手
搼	手 拳	扌 拳	才 拳
搽	手 茶	扌 茶	才 茶
搾	手 窄	扌 窄	才 窄
搿	手 合 手
摀	手 烏	扌 烏	才 烏
摁	手 恩	扌 恩	才 恩
摂	手 耳 丷 八	扌 耳 丷 八	才 耳 丷 八
摃	手 貢	扌 貢	才 貢
摉	手 穴 人 夕	扌 穴 人 夕	才 穴 人 夕
摋	手 殺	扌 殺	才 殺
摌	手 產	扌 產	才 產
摍	手 宿	扌 宿	才 宿
摎	手 翏	扌 翏	才 翏
摏	手 舂	扌 舂	才 舂
摐	手 從	扌 從	才 從
摑	手 國	扌 國	才 國
摒	手 屏	扌 屏	才 屏
摓	手 逢	扌 逢	才 逢
摔	手 率	扌 率	才 率
摕	手 帶	扌 帶	才 帶
摖	手 祭	扌 祭	才 祭
摘	手 啇	扌 啇	才 啇
摙	手 連	扌 連	才 連
摚	手 堂	扌 堂	才 堂
摛	手 离	扌 离	才 离
摜	手 貫	扌 貫	才 貫
摝	手 鹿	扌 鹿	才 鹿
摞	手 累	扌 累	才 累
摟	手 婁	扌 婁	才 婁
摠	手 悤	扌 悤	才 悤
摡	手 既	扌 既	才 既
摢	手 虖	扌 虖	才 虖
摣	手 虘	扌 虘	才 虘
摤	手 爽	扌 爽	才 爽
摥	手 丿 一 昜	扌 丿 一 昜	才 丿 一 昜
摦	手 瓠	扌 瓠	才 瓠
摧	手 崔	扌 崔	才 崔
摨	手 犀	扌 犀	才 犀
摩	麻 手
摪	手 將	扌 將	才 將
摫	手 規	扌 規	才 規
摬	手 竟	扌 竟	才 竟
摭	手 庶	扌 庶	才 庶
摮	敖 手
摯	執 手
摰	埶 手
摱	手 曼	扌 曼	才 曼
摲	手 斬	扌 斬	才 斬
摳	手 區	扌 區	才 區
摴	手 雩	扌 雩	才 雩
摵	手 戚	扌 戚	才 戚
摶	手 專	扌 專	才 專
摷	手 巢	扌 巢	才 巢
摸	手 莫	扌 莫	才 莫
摹	莫 手
摺	手 習	扌 習	才 習
摻	手 參	扌 參	才 參
摼	手 堅	扌 堅	才 堅
摽	手 票	扌 票	才 票
摾	手 强	扌 强	才 强
摿	手 人 音	扌 人 音	才 人 音
撀	殸 手	声 殳 手
撁	手 牽	扌 牽	才 牽
撂	手 畧	扌 畧	才 畧	手 田 各
撃	車 殳 手
撅	手 厥	扌 厥	才 厥
撆	敝 手
撇	手 敝	扌 敝	才 敝
撈	手 勞	扌 勞	才 勞
撉	敦 手
撊	手 閒	扌 閒	才 閒
撋	手 閏	扌 閏	才 閏
撌	手 貴	扌 貴	才 貴
撍	手 旡 旡 日	扌 旡 旡 日	才 旡 旡 日	手 朁	扌 朁	才 朁
撎	手 壹	扌 壹	才 壹
撏	手 尋	扌 尋	才 尋
撐	手 牚	扌 牚	才 牚	手 尚 牙
撒	手 散	扌 散	才 散
撓	手 堯	扌 堯	才 堯
撔	手 景	扌 景	才 景
撕	手 斯	扌 斯	才 斯
撖	手 敢	扌 敢	才 敢
撗	手 黃	扌 黃	才 黃
撘	手 答	扌 答	才 答
撙	手 尊	扌 尊	才 尊
撚	手 然	扌 然	才 然
撛	手 粦	扌 粦	才 粦
撜	手 登	扌 登	才 登
撝	手 爲	扌 爲	才 爲
撞	手 童	扌 童	才 童
撟	手 喬	扌 喬	才 喬
撠	手 戟	扌 戟	才 戟
撡	手 叅	扌 叅	才 叅
撢	手 覃	扌 覃	才 覃
撣	手 單	扌 單	才 單
撤	手 育 攵	扌 育 攵	才 育 攵
撥	手 發	扌 發	才 發
撦	手 奢	扌 奢	才 奢
撧	手 絕	扌 絕	才 絕
撨	手 焦	扌 焦	才 焦
撩	手 尞	扌 尞	才 尞
撪	手 厶 大 車	扌 厶 大 車	才 厶 大 車
撫	手 無	扌 無	才 無
撬	手 毳	扌 毳	才 毳
播	手 番	扌 番	才 番
撮	手 最	扌 最	才 最
撰	手 巽	扌 巽	才 巽
撱	手 隋	扌 隋	才 隋
撲	手 菐	扌 菐	才 菐
撳	手 欽	扌 欽	才 欽
撴	手 敦	扌 敦	才 敦
撹	手 覚	扌 覚	才 覚
撻	手 達	扌 達	才 達
撼	手 感	扌 感	才 感
撽	手 敫	扌 敫	才 敫
撾	手 過	扌 過	才 過
撿	手 僉	扌 僉	才 僉
擀	手 幹	扌 幹	才 幹
擁	手 雍	扌 雍	才 雍
擂	手 雷	扌 雷	才 雷
擃	手 農	扌 農	才 農
擄	手 虜	扌 虜	才 虜
擅	手 亶	扌 亶	才 亶
擆	手 著	扌 著	才 著
擇	手 睪	扌 睪	才 睪
擈	手 業	扌 業	才 業
擉	手 蜀	扌 蜀	才 蜀
擊	車 凵 殳 手
擋	手 當	扌 當	才 當
擌	手 筴	扌 筴	才 筴
操	手 品 木	扌 品 木	才 品 木	扌 喿
擎	敬 手
擏	手 敬	扌 敬	才 敬
擐	手 睘	扌 睘	才 睘
擑	手 戢	扌 戢	才 戢
擒	手 禽	扌 禽	才 禽
擓	手 匯	扌 匯	才 匯
擔	手 詹	扌 詹	才 詹
擕	手 雋	扌 雋	才 雋
擖	手 葛	扌 葛	才 葛
擗	手 辟	扌 辟	才 辟
擘	辟 手
擙	手 奧	扌 奧	才 奧
據	手 豦	扌 豦	才 豦
擛	手 葉	扌 葉	才 葉
擝	手 盟	扌 盟	才 盟
擟	手 爾	扌 爾	才 爾
擠	手 齊	扌 齊	才 齊
擡	手 臺	扌 臺	才 臺
擢	手 翟	扌 翟	才 翟
擣	手 壽	扌 壽	才 壽
擤	手 鼻	扌 鼻	才 鼻
擥	臣 丿 一 丶 网 手	臣 丿 一 丶 罒 手
擦	手 察	扌 察	才 察
擧	與 手
擨	手 歋	扌 歋	才 歋
擩	手 需	扌 需	才 需
擪	厭 手
擫	手 厭	扌 厭	才 厭
擬	手 疑	扌 疑	才 疑
擭	手 蒦	扌 蒦	才 蒦
擮	手 截	扌 截	才 截
擯	手 賓	扌 賓	才 賓
擰	手 寧	扌 寧	才 寧
擱	手 閣	扌 閣	才 閣
擲	手 鄭	扌 鄭	才 鄭
擳	手 節	扌 節	才 節
擴	手 廣	扌 廣	才 廣
擵	手 摩	扌 摩	才 摩
擶	手 箭	扌 箭	才 箭
擷	手 頡	扌 頡	才 頡
擸	手 巤	扌 巤	才 巤
擹	手 歎	扌 歎	才 歎
擺	手 罷	扌 罷	才 罷
擻	手 數	扌 數	才 數
擼	手 魯	扌 魯	才 魯
擽	手 樂	扌 樂	才 樂
擾	手 憂	扌 憂	才 憂
擿	手 適	扌 適	才 適
攀	棥 大 手	林 爻 大 手	木 木 乂 乂 大 手
攁	手 養	扌 養	才 養
攂	手 畾	扌 畾	才 畾
攃	手 蔡	扌 蔡	才 蔡
攄	手 慮	扌 慮	才 慮
攅	手 賛	扌 賛	才 賛
攆	手 輦	扌 輦	才 輦
攇	手 憲	扌 憲	才 憲
攈	手 麇	扌 麇	才 麇
攉	手 霍	扌 霍	才 霍
攊	手 歷	扌 歷	才 歷
攋	手 賴	扌 賴	才 賴
攌	手 圜	扌 圜	才 圜
攍	手 嬴	扌 嬴	才 嬴
攎	手 盧	扌 盧	才 盧
攏	手 龍	扌 龍	才 龍
攐	手 褰	扌 褰	才 褰
攑	手 舉	扌 舉	才 舉
攓	手 蹇	扌 蹇	才 蹇
攔	手 闌	扌 闌	才 闌
攕	手 韱	扌 韱	才 韱
攖	手 嬰	扌 嬰	才 嬰
攗	手 麋	扌 麋	才 麋
攘	手 襄	扌 襄	才 襄
攙	手 毚	扌 毚	才 毚
攛	手 竄	扌 竄	才 竄
攜	手 雟	扌 雟	才 雟
攝	手 聶	扌 聶	才 聶
攞	手 羅	扌 羅	才 羅
攟	手 麕	扌 麕	才 麕
攠	手 靡	扌 靡	才 靡
攡	手 離	扌 離	才 離
攢	手 贊	扌 贊	才 贊
攣	絲 言 手	糸 言 糸 手	䜌 手
攤	手 難	扌 難	才 難
攥	手 纂	扌 纂	才 纂
攦	手 麗	扌 麗	才 麗
攧	手 顛	扌 顛	才 顛
攨	手 穴 瓜 瓜 瓜	扌 穴 瓜 瓜 瓜	才 穴 瓜 瓜 瓜
攩	手 黨	扌 黨	才 黨
攪	手 覺	扌 覺	才 覺
攫	手 瞿	扌 瞿	才 瞿
攬	手 覽	扌 覽	才 覽
攭	手 蠡	扌 蠡	才 蠡
攮	手 囊	扌 囊	才 囊
支	十 又
攰	支 力
攱	立 支
攲	奇 支
攳	支 尋
攴	卜 又
攵	丿 一 乂
收	丩 攴	丩 攵
攷	丂 攴	丂 攵
攸	人 丨 攴	亻 丨 攵
改	己 攴	己 攵
攺	已 攴	已 攵	巳 攴	巳 攵
攻	工 攴	工 攵
攼	干 攴	干 攵
攽	分 攴	分 攵
放	方 攴	方 攵
政	正 攴	正 攵
敀	白 攴	白 攵
敁	占 攴
敂	句 攴	句 攵
敃	民 攴	民 攵
敄	矛 攴	矛 攵
故	古 攴	古 攵
敆	合 攴
敇	朿 攴	朿 攵
效	交 攴	交 攵
敉	米 攴	米 攵
敊	尗 攴
敋	各 攴	各 攵
敍	余 攴
敎	乂 一 丿 子 攴	乂 一 丿 子 攵
敏	每 攴	每 攵
敐	辰 攴	辰 攵
救	求 攴	求 攵
敒	伸 攴	伸 攵
敓	兌 攴	兌 攵
敔	吾 攴	吾 攵
敕	束 攴	束 攵
敖	土 方 攴	土 方 攵
敗	貝 攴	貝 攵
敘	余 攴	余 攵
教	孝 攴	孝 攵
敜	念 攴	念 攵
敝	丷 巾 八 攴	丷 巾 八 攵	㡀 攴	㡀 攵
敞	尚 攴	尚 攵
敟	典 攴	典 攵
敠	叕 攴
敡	易 攴
敢	丅 耳 攴	丅 耳 攵
散	井 月 攴	井 月 攵
敤	果 攴
敥	炎 攴
敦	享 攴	享 攵
敧	奇 攴
敨	咅 攴	咅 攵
敪	叕 攴	叕 攵
敫	白 方 攴	白 方 攵
敬	茍 攴	茍 攵
敭	易 攴	易 攵
敮	臿 攴
敯	昬 攴
敱	豈 攴
敲	高 攴	高 攵
敳	豈 攴	豈 攵
整	敕 正	束 攵 正
敵	啇 攴	啇 攵
敶	陳 攴	陳 攵
敷	旉 攴	旉 攵	甫 方 攴
數	婁 攴	婁 攵
敹	卜 冖 一 米 攴	卜 冖 一 米 攵
敺	區 攴
敻	刀 内 目 夕	刀 内 目 夂
敼	喜 攴
敽	喬 攴
敿	喬 攴	喬 攵
斀	蜀 攴
斁	睪 攴	睪 攵
斂	僉 攴	僉 攵
斃	敝 死
斄	未 攵 厂 來
斅	學 攴
斆	學 攴	學 攵
文	亠 乂
斈	文 子
斉	文 丿 二 丨
斊	文 耳
斌	文 武
斍	文 見
斎	文 丿 二 小 丨
斐	非 文
斑	王 文 王	玉 文 王
斒	文 扁
斔	文 蟲 臾	文 虫 臾
斕	文 闌
斖	文 臼 同 冖 且
斗	丶 丶 一 丨
斘	夕 斗
料	米 斗
斚	厶 厶 冖 斗
斛	角 斗
斜	余 斗
斝	口 口 冖 斗
斞	臾 斗
斟	甚 斗
斠	冓 斗
斡	十 日 十 人 斗
斢	黃 斗
斣	蜀 斗
斤	厂 丅
斥	斤 丶
斦	斤 斤
斧	父 斤
斨	爿 斤
斪	句 斤
斫	石 斤
斬	車 斤
斮	昔 斤
斯	其 斤
新	亲 斤	立 木 斤
斱	者 斤
斳	堇 斤
斴	粦 斤
斵	卯 亞 斤
斶	斤 蜀
斷	丨 二 幺 幺 幺 幺 斤
斸	屬 斤
方	亠 勹	亠 刀
斺	方 丿 一 介
斻	方 亢
於	方 人 冫
施	方 丿 一 也
斾	方 丿 一 巾
斿	方 丿 一 子
旁	亠 丷 冖 方
旂	方 丿 一 斤
旃	方 丿 一 円
旄	方 丿 一 毛
旅	方 丿 一 氏
旆	方 丿 一 巿
旇	方 丿 一 皮
旈	方 亠 厶 川	方 巟	方 㐬
旉	甫 方
旊	方 丿 一 瓦
旋	方 丿 一 疋
旌	方 丿 一 生
旍	方 丿 一 令
旎	方 丿 一 尼
族	方 丿 一 矢
旐	方 丿 一 兆
旑	方 奇
旒	方 丿 一 亠 厶 川	方 丿 一 巟	方 丿 一 㐬
旓	方 丿 一 肖
旔	方 建
旖	方 丿 一 奇
旗	方 丿 一 其
旘	方 丿 一 戠
旙	方 番
旚	方 丿 一 票
旛	方 丿 一 番
旜	方 丿 一 亶
旝	方 丿 一 會
旞	方 丿 一 遂
旟	方 丿 一 與
旡	厂 尢	匸 丿 乚
既	艮 旡
旣	白 匕 旡
旤	咼 旡
日	口 一	囗 一	囗 丶
旦	日 一
旨	匕 日
早	日 十
旪	日 十
旫	日 刀
旬	勹 日
旭	九 日
旮	九 日
旯	日 九
旰	日 干
旱	日 干
旲	日 大
旳	日 勺
旴	日 于
旵	日 山
旹	山 一 日	屮 一 日
旺	日 王
旻	日 文
旼	日 文
旽	日 屯
旾	屯 日
旿	日 午
昀	日 勻	日 匀
昁	日 巿
昂	日 卬
昃	日 仄
昄	日 反
昅	日 及
昆	日 比
昇	日 升
昈	日 戶
昉	日 方
昊	日 天
昋	夭 日
昌	日 曰	日 日
昍	日 日
明	日 月
昏	氏 日
昐	日 分
昑	日 今
昒	日 勿
易	日 勿
昔	井 日
昕	日 斤
昖	日 公
昗	日 六
昘	日 方
昚	大 丷 日
昛	日 巨
昜	日 一 勿
昝	处 日
昞	日 丙
星	生 日
映	日 央
昡	日 玄
昢	日 出
昣	日 人 彡
昤	日 令
春	手 乀 日	龹 日
昦	日 夰
昧	日 未
昨	日 乍
昩	日 末
昪	日 弁
昫	日 句
昬	民 日
昭	日 召
昮	日 功
是	日 疋	曰 疋
昰	日 正
昱	日 立
昲	日 弗
昳	日 失
昴	日 卯
昶	永 日
昷	日 皿
昸	日 冬
昹	日 永
昺	日 丙
昻	日 卬
昿	日 広
晀	日 兆
晁	日 兆
時	日 寺
晃	日 光
晄	日 光
晅	日 亘
晆	日 圭
晇	日 夸
晈	日 交
晉	一 厶 厶 一 日
晊	日 至
晌	日 向
晍	日 同
晎	日 共
晏	日 安
晐	日 亥
晑	日 向
晗	日 含
晘	日 旱
晙	日 夋
晚	日 免
晛	日 見
晜	日 弟
晝	聿 旦
晞	日 希
晟	日 成
晠	日 成
晡	日 甫
晢	折 日
晣	日 折
晤	日 吾
晥	日 完
晦	日 每
晧	日 告
晨	日 辰
晩	日 免
晪	日 典
晫	日 卓
晬	日 卒
晭	日 周
普	並 日	丷 晋
景	日 京
晰	日 析
晱	日 炎
晲	日 兒
晳	析 日
晴	日 青
晵	戶 攵 日
晶	日 日 日
晷	日 咎
晸	日 政
晹	日 易
智	知 日
晻	日 奄
晼	日 宛
晽	日 林
晾	日 京
晿	日 昌
暀	日 往
暁	日 尭
暄	日 宣
暅	日 恒
暆	日 施
暇	日 叚
暈	日 軍
暉	日 軍
暊	日 頁
暋	敃 日
暌	日 癸
暍	日 曷
暎	日 英
暏	日 者
暐	日 韋
暑	日 者
暒	日 星
暓	敄 日
暔	日 南
暕	日 柬
暖	日 爰
暗	日 音
暘	日 昜
暙	日 春
暚	日 爪 缶	日 爫 缶
暛	日 差
暜	立 立 日
暝	日 冥
暞	日 臬
暟	日 豈
暠	日 高
暡	日 翁
暢	申 昜
暣	日 氣
暤	日 皋
暥	日 妟
暦	厂 林 日
暨	既 旦
暩	日 祭
暪	日 廿 冂 丨 入 入	日 廿 冂 丨 入 入	日 㒼
暫	斬 日
暬	埶 日
暭	日 皐
暮	莫 日
暯	日 莫
暰	日 從
暱	日 匿
暲	日 章
暳	日 彗
暴	日 共 水	日 恭
暵	日 革 大
暶	日 旋
暷	日 專
暸	日 尞
暹	日 進
暺	日 單
暻	日 景
暼	敝 日
暽	日 粦
暾	日 敦
暿	日 喜
曀	日 壹
曁	旣 旦
曂	日 黃
曃	日 逮
曄	日 華
曅	日 華
曆	厂 禾 禾 日	厂 秝 日
曇	日 雲
曈	日 童
曉	日 堯
曊	日 費
曋	日 覃
曌	明 空
曍	日 臯
曎	日 睪
曏	日 鄉
曐	晶 生
曑	晶 人 彡
曒	日 敫
曓	日 出 大 本
曔	日 敬
曕	日 詹
曖	日 愛
曗	日 業
曘	日 需
曙	日 署
曚	日 蒙
曛	日 熏
曜	日 翟
曝	日 暴
曞	日 厲
曟	晶 辰
曠	日 廣
曡	晶 冝
曣	日 燕
曤	日 霍
曥	日 盧
曦	日 羲
曧	日 融
曨	日 龍
曩	日 囊
曪	日 羅
曫	絲 言 日	糸 言 糸 日	䜌 日
曬	日 麗
曭	日 黨
曮	日 嚴
曯	日 屬
曰	曰 丶	曰 一
曱	口 丅
曲	囗 卄	曰 丨 丨
曳	曰 乁 丿
更	一 日 人	一 曰 人	一 田 人	一 申 人
曵	曰 乀 丿 丶	日  乀 丿 丶
曶	勿 曰	勿 日
曷	日 勹 丨 一 人
書	聿 曰
曹	卄 曰 日	一 丨 丨 曰 日
曺	一 由 曰	一 由 日
曼	曰 目 又
曽	丷 田 曰	丷 田 日
曾	丷 口 丨 丷 曰	八 口 丨 丷 曰
替	夫 夫 曰	夫 夫 日
最	曰 取	日 取
朁	兓 日	旡 旡 日
朂	曰 耳 力	日 耳 力
會	人 一 口 丨 丷 曰
朄	申 柬
朅	去 曷
朆	曾 勿
朇	會 卑
月	冂 一 一
有	一 丿 月
朊	月 元
朋	月 月
朌	月 分
服	月 卩 又
朎	月 令
朏	月 出
朐	月 句
朒	月 肉
朓	月 兆
朔	屰 月
朕	肉 关	月 关
朖	月 良
朗	良 月
朘	月 夋
朙	囧 月
朚	亡 明
望	亡 月 王
朜	月 享
朝	十 日 十 月	卓 月	車 月
朞	其 月
期	其 月
朠	月 英
朡	月 凶 八 夕	月 凶 八 夂
朢	臣 月 壬
朣	月 童
朤	月 月 月 月
朦	月 蒙
朧	月 龍
木	十 人	十 八	一 小
朩	一 小
未	一 木
末	木 一
本	木 一
札	木 乚
朮	木 丶	十 儿 丶
朱	丿 未	丶 未	丿 一 木 未
朲	木 人
朳	木 八
朴	木 卜
朵	几 木
朶	乃 木
朷	木 刀
朸	木 力
朹	木 九
朻	木 丩
朼	木 匕
朽	木 丂
朾	木 丁
朿	木 冂
杄	木 千
杅	木 于
杆	木 干
杇	木 亏
杈	木 叉
杉	木 彡
杊	木 川
杋	木 凡
杌	木 兀
杍	木 子
李	木 子
杏	木 口
材	木 才
村	木 寸
杒	木 刃
杓	木 勺
杔	木 乇
杕	木 大
杖	木 丈
杗	木 亡
杘	尸 木 
杙	木 弋
杚	木 乞
杛	木 弓
杜	木 土
杝	木 也
杞	木 己
束	木 口
杠	木 工
杧	木 亡
杪	木 少
杫	木 止
杬	木 元
杭	木 亢
杮	木 巿
杯	木 不
杰	木 火	木 灬
東	木 日
杲	日 木
杳	木 日
杴	木 欠
杵	木 午
杶	木 屯
杷	木 巴
杸	木 殳
杹	木 化
杺	木 心
杻	木 丑
杼	木 予
杽	木 手
松	木 公
板	木 反
枀	公 木 
枂	木 月
枃	木 勻
枅	木 开
枆	木 毛
枇	木 比
枈	比 木
枉	木 王
枊	木 卬
枋	木 方
枌	木 分
枍	木 兮
枎	木 夫
枏	木 冄
析	木 斤
枑	木 互
枒	木 牙
枓	木 斗
枔	木 今
枕	木 冘
枖	木 夭
林	木 木
枘	木 內
枙	木 厄
枚	木 攴	木 攵
枛	木 爪
果	日 木
枝	木 支
枡	木 升
枬	木 丹
枮	木 占
枯	木 古
枰	木 平
枱	木 台
枲	台 木
枳	木 只
枵	木 号
架	加 木
枷	木 加
枸	木 句
枹	木 包
枺	木 末
枻	木 世
枼	世 木
枽	卋 木
枾	木 亠 十 丿 丨
枿	木 卉
柀	木 皮
柁	木 它
柂	木 丿 一 也
柃	木 令
柄	木 丙
柅	木 尼
柆	木 立
柇	木 禾
柈	木 半
柉	木 乏
柊	木 冬
柋	代 木
柌	木 司
柍	木 央
柎	木 付
柏	木 白
某	甘 木
柑	木 甘
柒	水 七 木
染	水 九 木	氵 九 木	氿 木
柔	矛 木
柕	木 矛
柖	木 召
柗	木 八 口
柘	木 石
柙	木 甲
柚	木 由
柛	木 申
柝	木 拆
柞	木 乍
柟	木 冉
柡	木 二 水
柢	木 氐
柣	木 失
柤	木 且
查	木 旦
柦	木 旦
柧	木 瓜
柩	木 久
柪	木 幼
柫	木 弗
柬	木 口 丷	木 囗 丷
柭	木 犮
柮	木 出
柯	木 可
柰	木 示
柱	木 主
柲	木 必
柳	木 卯
柴	此 木
柵	木 冊
柶	木 四
柷	木 兄
柸	木 丕
柹	木 丿 ㇉ 丨 丿	木 𠂔
柺	木 口 刀	木 另
査	木 且
柼	木 穴
柾	木 正
柿	木 市
栀	木 卮
栁	木 夕 卩
栂	木 母
栄	小 冖 木
栐	木 永
栒	木 旬
栓	木 全
栔	丰 刀 木 
栕	木 臣
栗	西 木	襾 木	覀 木
栘	木 多
栙	木 夅
栚	木 关
栛	木 劦
栜	木 朿
栝	木 舌
栞	干 干 木
栟	木 并	木 幷
栠	任 木
校	木 交
栢	木 百
栣	木 任
栤	木 冰
栥	次 木
栦	木 州
栧	木 曳
栨	木 次
栩	木 羽
株	木 朱
栫	木 存
栬	木 色
栭	木 而
栮	木 耳
栯	木 有
栰	木 伐
栱	木 共
栲	木 考
栳	木 老
栴	木 丿 一 円
栵	木 列
核	木 亥
根	木 艮
栺	木 旨
栻	木 式
格	木 各
栽	十 戈 木	土 戈 木	𢦏 木
栿	木 伏
桀	舛 木
桁	木 行
桂	木 圭
桃	木 兆
桄	木 光
桅	木 危
框	木 匡
桇	如 木
案	安 木
桉	木 安
桊	丷 夫 木	𠔉 木
桋	木 夷
桌	木 卜 日
桍	木 夸
桎	木 至
桏	木 邛
桐	木 同
桑	木 叒	木 又 又 又
桒	卉 木
桓	木 亘
桔	木 吉
桕	木 臼
桖	木 血
桗	木 朶
桘	木 戶 乛 一	木 户 乛 一
桙	木 牟
桚	木 巛 夕
桜	木 小 女
桟	木 戈 二	木 戋 一
桫	木 沙
桬	沙 木
桭	木 辰
桮	木 否
桯	木 呈
桰	木 氏 口
桱	木 巠
桲	木 孛
桳	木 厶 大 十
桴	木 孚
桵	木 妥
桶	木 甬
桷	木 角
桸	木 希
桹	木 良
桺	木 丣
桻	木 夆
桼	木 水
桽	木 坐
桾	木 君
桿	木 旱
梀	木 束
梁	水 刅 木	氵 刅 木
梂	木 求
梃	木 廷
梄	木 酉
梅	木 每
梆	木 邦
梇	木 弄
梈	木 亨
梉	木 壯
梊	折 木
梋	木 肙
梌	木 余
梍	木 白 七
梎	木 皂
梏	木 告	木 牛 口
梐	木 坒	木 比 土
梑	木 狄
梒	木 含
梓	木 辛
梔	木 巵
梕	木 忍
梖	木 貝
梗	木 更
梘	木 見
梙	木 串
梚	木 免
梛	木 那
梜	木 夾
條	攸 木
梞	木 忌
梟	鳥 木
梠	木 呂
梡	木 完
梢	木 肖
梣	木 岑
梤	木 山 分
梥	宀 枀
梧	木 吾
梨	利 木
梩	木 里
梪	木 豆
梫	木 彐 冖 又
梬	木 甹
梭	木 夋
梮	木 局
梯	木 弟
械	木 戒
梱	木 困
梲	木 兌
梳	木 亠 厶 川	木 巟	木 㐬
梴	木 延
梵	木 木 凡
梶	木 尾
梷	占 又 木
梸	木 利
梹	木 兵
梽	木 志
棃	禾 勹 丿 木
棄	亠 厶 廿 木
棅	木 秉
棆	木 侖
棇	木 忩	木 公 心
棈	木 青
棉	木 帛
棊	其 木
棋	木 其
棌	木 采
棍	木 昆
棎	木 穼
棏	木 日 一 寸	木 㝵
棐	非 木
棑	木 非
棒	木 奉
棓	木 咅
棔	木 昏
棕	木 宗
棖	木 長
棗	朿 朿
棘	朿 朿
棙	木 戾
棚	木 朋
棛	木 育
棜	木 於
棝	木 固
棞	木 囷	木 囗 禾
棟	木 東
棠	尚 木
棡	木 岡
棢	木 罔
棣	木 隶
棤	木 昔
棥	木 爻 木	林 爻
棦	木 爭
棧	木 戔
棨	戶 攵 木
棩	木 片 一 爿
棪	木 炎
棫	木 或
棬	木 卷
棭	木 夜
森	木 木 木	木 林
棯	木 念
棰	木 垂
棱	木 夌
棲	木 妻
棳	木 叕
棴	木 服
棵	木 果
棶	木 來
棷	木 取
棸	取 木
棹	木 卓
棺	木 官
棻	芬 木
棼	林 分
棽	林 今
棾	林 冗
棿	木 兒
椀	木 宛
椁	木 享
椂	木 录
椃	木 虎
椄	木 妾
椅	木 奇
椆	木 周
椇	木 具
椈	木 匊
椉	亠 舛 木
椊	木 卒
椋	木 京
椌	木 空
植	木 直
椎	木 隹
椏	木 亞
椐	木 居
椑	木 卑
椒	木 叔
椓	木 豖
椔	木 甾
椕	林 分	木 分 木
椖	木 房
椗	木 定
椘	林 之
検	木 人 一 口 人
椞	析 木
椥	木 知
椪	木 並
椯	木 耑
椰	木 耶
椱	木 复
椲	木 韋
椳	木 畏
椴	木 段
椵	木 叚
椶	木 凶 八 夕	木 凶 八 夂
椷	木 咸
椸	木 施
椹	木 甚
椺	木 保
椻	木 匽
椼	木 衍
椽	木 彖
椾	木 前
椿	木 春
楀	木 禹
楁	木 客
楂	木 查
楃	木 屋
楄	木 扁
楅	木 畐
楆	木 要
楇	木 咼
楈	木 疋 月
楉	木 若
楊	木 昜	木 日 一 勿
楋	木 剌
楌	木 彦
楍	木 口 口 口
楎	木 軍
楏	木 奎
楐	木 界
楑	木 癸
楒	木 思
楓	木 風
楔	木 契
楕	木 左 月
楖	木 即
楗	木 建
楘	敄 木
楙	林 矛	木 矛 木
楚	林 疋
楛	木 苦
楜	木 胡
楝	木 柬
楞	木 网 方	木 罒 方
楟	木 亭
楠	木 南
楡	木 俞
楢	木 酋
楣	木 眉
楤	木 怱
楥	木 爰
楦	木 宣
楧	木 英
楨	木 貞
楩	木 便
楪	木 枼
楫	木 咠	木 口 耳
楬	木 曷
業	业 丷 二 木
楮	木 者
楯	木 盾
楰	木 臾
楱	木 奏
楲	木 威
楳	木 某
楴	木 帝
極	木 亟
楶	木 咨	次 呆
楷	木 皆
楸	木 秋
楹	木 盈
楺	木 柔
楻	木 皇
楽	冰 白 丶 丶 木	冫 白 丶 丶 木
榀	木 品
概	木 既
榃	林 田
榆	木 俞
榊	木 神
榍	木 屑
榎	木 夏
榏	木 益
榐	木 展
榑	木 尃
榒	木 弱
榓	木 必 皿
榔	木 郎
榕	木 容
榖	士 冖 一 木 殳
榗	木 晉
榘	矩 木
榙	木 荅
榚	木 羔
榛	木 秦
榜	木 旁
榞	木 原
榟	木 宰
榠	木 冥
榡	木 素
榢	木 家
榣	木 月 缶	木 䍃
榤	木 桀
榥	木 晃
榦	十 日 十 人 木
榧	木 匪
榨	木 窄
榩	木 虔
榪	木 馬
榫	木 隼	木 隹 十
榬	木 袁
榭	木 射
榮	火 火 冖 木	𤇾 木
榯	木 時
榰	木 耆
榱	木 衰
榲	木 囚 皿	木 昷
榳	木 庭
榴	木 留
榵	木 茸
榶	木 唐
榷	木 隺
榸	木 埋
榹	木 虒
榺	肉 桊	月 桊
榻	木 日 羽	木 曰 羽
榼	木 盍
榽	木 奚
榾	木 骨
榿	木 豈
槀	高 木
槁	木 高
槂	木 孫
槃	般 木
槄	木 舀
槅	木 鬲
槆	木 荀
槇	木 真
槈	木 辱
槉	木 疾
槊	木 朔
構	木 冓
槌	木 追
槍	木 倉
槎	木 差
槏	木 兼
槐	木 鬼
槑	呆 呆
槒	木 畜
槓	木 貢
槔	木 皋
槕	木 卓
槖	士 冖 石 木
様	木 羊 水
槙	木 真
槜	木 隽
槢	木 習
槣	木 寄
槤	木 連
槥	木 彗
槦	木 庸
槧	木 斬
槨	木 郭
槩	木 既
槪	木 旣
槫	木 專
槬	木 瓠
槭	木 戚
槮	木 參
槯	木 崔
槰	木 逢
槱	木 酉 火	木 酉 灬
槲	木 斛
槳	將 木
槴	木 扈
槵	木 患
槶	木 國
槷	埶 木
槸	木 埶
槹	木 皐
槺	木 康
槻	木 規
槼	木 規
槽	木 曹
槾	木 曼
槿	木 堇
樀	木 啇
樁	木 舂
樂	幺 白 幺 木
樃	木 朗
樄	木 陳
樅	木 從
樆	木 离
樇	木 脩
樈	木 竟
樉	木 爽
樊	棥 大	木 爻 木 大
樋	木 通
樌	木 貫
樍	木 責
樎	木 宿
樏	木 累
樐	木 鹵
樑	木 梁
樒	木 密
樓	木 婁
樔	木 巢
樕	木 欶
樖	合 柯
樗	木 雩
樘	木 堂
標	木 票
樚	木 鹿
樛	木 翏
樜	木 庶
樝	木 虘
樞	木 區
樟	木 章
樠	木 廿 冂 丨 入 入	木 廿 冂 丨 入 入	木 㒼
模	木 莫
樢	木 鳥
樣	木 羕
樤	木 條
樥	木 莑
樦	木 竹 主
樧	木 殺 丶
樨	木 犀
権	木 丿 二 隹
樫	木 堅
樬	木 悤
樲	木 貳
樳	木 尋
樴	木 戠
樵	木 焦
樶	木 最
樷	林 取
樸	木 菐
樹	木 尌
樺	木 華
樻	木 貴
樼	木 孱
樽	木 尊
樾	木 越
樿	木 單
橀	木 亠 厶 川 皿	木 巟 皿	木 㐬 皿
橁	木 筍
橂	木 奠
橃	木 發
橄	木 敢
橅	木 無
橆	丿 一 卌 一 林
橇	木 毳
橈	木 堯
橉	木 粦
橊	木 畱
橋	木 喬
橌	木 閒
橍	木 閏
橎	木 番
橏	木 善
橐	一 中 冖 木 石
橑	木 尞
橒	木 雲
橓	木 舜
橔	木 敦
橕	木 牚
橖	木 棠
橗	木 萌
橘	木 矞	木 矛 冏
橙	木 登
橚	木 肅
橛	木 厥
橜	厥 木
橝	木 覃
橞	木 惠
機	木 幾
橠	木 袲
橡	木 象
橢	木 隋
橣	木 甯
橤	惢 木
橦	木 童
橧	木 曾
橨	木 賁
橩	木 焭
橪	木 然
橫	木 黃
橬	木 朁
橭	木 辜
橮	木 貿
橯	木 勞
橰	木 臯
橶	木 戟
橷	木 兠	木 北 白 几
橺	木 間
橽	木 達
橾	木 喿
橿	木 畺
檀	木 亶
檁	木 稟
檂	木 農
檃	爪 工 彐 木	爫 工 彐 木
檄	木 敫
檅	木 歲
檆	木 煔
檇	木 雋
檈	木 睘
檉	木 聖
檊	木 幹
檋	木 輂
檌	木 罪
檍	木 意
檎	木 禽
檏	木 業
檑	木 雷
檒	林 風
檓	木 毀
檔	木 當
檕	車 凵 殳 木
檖	木 遂
檗	辟 木
檘	木 辟
檙	木 鼎
檚	木 楚
檛	木 過
檜	木 會
檝	木 戢
檞	木 解
檟	木 賈
檠	敬 木
檡	木 睪
檢	木 僉
檣	木 嗇
檤	木 道
檥	木 義
檦	木 剽
檧	木 葱
檨	木 羨
檫	木 察
檬	木 蒙
檭	木 銀
檮	木 壽
檯	木 臺
檰	木 綿
檱	木 箕
檳	木 賓
檴	木 蒦
檵	木 丨 一 幺 幺 一 幺 幺
檶	木 奩
檷	木 爾
檸	木 寧
檹	木 旖
檺	木 豪
檻	木 監
檼	木 爪 工 彐 心	木 爫 工 彐 心	木 㥯
檽	木 需
檾	火 火 冖 林	𤇾 林
檿	壓 木
櫀	木 綦
櫁	木 蜜
櫂	木 翟
櫃	木 匱
櫄	木 熏
櫅	木 齊
櫆	木 魁
櫇	木 頗
櫈	木 凳
櫉	木 厂 尌
櫋	木 臱
櫌	木 憂
櫍	木 質
櫎	木 廣
櫏	木 遷
櫐	畾 木
櫑	木 畾
櫒	木 蔡
櫓	木 魯
櫔	木 厲
櫕	木 贊
櫖	木 慮
櫗	木 蔑
櫘	木 慧
櫙	木 區
櫚	木 閭	木 門 呂
櫛	木 節
櫜	一 中 冂 处 呆
櫝	木 賣
櫞	木 緣
櫟	木 樂
櫠	木 廢
櫡	木 箸
櫢	木 數
櫣	木 連
櫥	木 廚
櫧	木 諸
櫨	木 盧
櫩	木 閻
櫪	木 歷
櫫	木 豬
櫬	木 親
櫭	木 暨
櫮	木 噩
櫯	木 穌
櫰	木 褱
櫱	辥 木
櫲	木 豫
櫳	木 龍
櫴	木 賴
櫶	木 憲
櫸	木 舉
櫹	木 蕭
櫺	木 霝
櫻	木 嬰
櫼	木 韱
櫽	隱 木
櫾	木 爪 缶 系	木 爫 缶 系
櫿	木 營
欀	木 襄
欁	林 農	木 農 木
欂	木 薄
欃	木 毚
欄	木 闌
欅	木 舉
欆	木 雙
欇	木 聶
欈	木 巂
欉	木 叢
權	木 雚
欋	木 瞿
欎	棥 冖 艮 寸
欏	木 羅
欐	木 麗
欑	木 贊
欒	絲 言 木	糸 言 糸 木	䜌 木
欓	木 黨
欔	木 矍
欖	木 覽
欘	木 屬
欙	木 纍
欚	木 蠡
欛	木 霸
欜	木 囊
欝	棥 网 艮 寸	棥 罒 艮 寸	棥 罒 艮 寸
欞	木 靈
欠	刀 人
次	冫 欠	冰 欠
欣	斤 欠
欥	日 欠
欦	今 欠
欨	句 欠
欩	召 欠
欪	出 欠
欫	午 止 欠
欬	亥 欠
欭	因 欠
欮	屰 欠
欯	吉 欠
欰	血 欠
欱	合 欠
欲	谷 欠
欳	卜 冊 欠
欴	良 欠
欵	匕 矢 欠
欶	束 欠
欷	希 欠
欸	矣 欠
欹	奇 欠
欺	其 欠
欻	炎 欠
欼	叕 欠
欽	金 欠	釒 欠
款	士 示 欠
欿	臽 欠
歀	柰 欠
歁	甚 欠
歂	耑 欠
歃	臿 欠
歅	垔 欠
歆	音 欠
歇	曷 欠
歈	俞 欠
歉	兼 欠
歊	高 欠
歋	虒 欠
歌	哥 欠
歍	烏 欠
歎	革 大 欠
歏	堇 欠
歐	區 欠
歑	虖 欠
歒	啇 欠
歓	丿 二 隹 欠
歔	虛 欠
歕	賁 欠
歖	喜 欠
歗	肅 欠
歘	焱 欠
歙	翕 欠
歛	僉 欠
歜	蜀 欠
歝	睪 欠
歞	日 幺 幺 火 欠	日 幺 幺 灬 欠	㬎 欠
歟	與 欠
歠	叕 酉 欠
歡	雚 欠
止	上 丨
正	一 止
此	止 匕
步	止 小	止 亅 丶 丿	止 少
武	一 弋 止
歧	止 支
歨	止 卜 人
歩	止 少
歪	不 正
歫	止 巨
歬	止 舟
歭	止 寺
歮	止 止 止
歯	止 米 凵
歰	刃 刃 止 止
歱	止 重
歲	止 戊 丁 丶 丿	止 戊 一 小
歳	止 戊 一 小
歴	厂 林 止
歵	止 責
歶	此 禺
歷	厂 禾 禾 止	厂 秝 止
歸	𠂤 止 帚
歹	一 夕
歺	丨 歹	卜 夕
死	歹 匕	一 夕 匕
歽	歹 斤
歾	歹 勿
歿	歹 勹 又
殀	歹 夭
殂	歹 且
殃	歹 央
殄	歹 人 彡
殅	歹 生
殆	歹 台
殈	歹 血
殉	歹 旬
殊	歹 朱
殌	歹 巠
殍	歹 孚
殎	歹 夾
殏	歹 求
殐	歹 束
殑	歹 克
殔	歹 隶
殕	歹 咅
殖	歹 直
殗	歹 奄
殘	歹 戔
殙	歹 昏
殛	歹 亟
殜	歹 枼
殞	歹 員
殟	歹 昷
殠	歹 臭
殢	歹 帶
殣	歹 堇
殤	歹 丿 一 昜
殥	歹 寅
殦	歹 鳥
殧	歹 就
殨	歹 貴
殩	歹 粲
殪	歹 壹
殫	歹 單
殬	歹 睪
殭	歹 畺
殮	歹 僉
殯	歹 賓
殰	歹 賣
殲	歹 韱	歹 人 人 戈 韭
殳	几 又
段	丿 丰 殳
殶	主 殳
殷	丶 丿 彐 ㇆ 殳	㐆 殳
殸	声 殳
殹	医 殳
殺	杀 殳	乂 木 殳
殻	壳 殳
殼	壳 一 殳
殽	肴 殳
殾	者 殳
殿	尸 共 殳
毀	臼 土 殳
毃	高 殳
毄	車 口 殳
毅	豙 殳	立 豕 殳
毆	區 殳
毇	臼 米 殳
毈	卵 段
毉	殹 巫
毊	殸 喬
母	丨 一 二 丶 丶 亅
毎	丿 一 毋
每	丿 一 母
毐	士 母
毑	母 也
毒	丰 毋	丰 母
毓	每 亠 厶 川	每 巟	每 㐬
比	匕 匕
毖	比 必
毗	田 比
毘	田 比
毚	刀 口 比 兔	㲋 兔
毛	丿 一 匕
毞	比 毛
毠	加 毛
毢	毛 西
毣	羽 毛
毤	兊 毛
毥	毛 旬
毦	耳 毛
毧	毛 戎
毨	毛 先
毩	毛 米
毪	毛 牟
毫	亠 口 冂 毛
毬	毛 求
毭	豆 毛
毯	毛 炎
毰	毛 咅
毱	毛 匊
毲	叕 毛
毳	毛 毛 毛
毴	毛 非
毷	冒 毛
毸	毛 思
毹	俞 毛
毺	毛 俞
毻	左 月 毛
毼	曷 毛
毽	毛 建
毾	日 羽 毛
毿	參 毛
氀	婁 毛
氁	毛 莫
氂	未 攴 厂 毛	未 攵 厂 毛
氃	童 毛
氄	矞 毛
氅	敞 毛
氆	毛 普
氈	亶 毛
氉	喿 毛
氊	毛 亶
氋	蒙 毛
氌	毛 魯
氍	瞿 毛
氎	畾 宀 彑 毛
氐	氏 丶
氒	氏 十
氓	亡 民
氕	氣 丿	气 丿
氖	氣 乃	气 乃
気	氣 乂	气 乂
氘	氣 丿 丨	气 丿 丨
氙	氣 山	气 山
氚	氣 川	气 川
氛	氣 分	气 分
氜	氣 日	气 日
氝	氣 內	气 內
氟	氣 弗	气 弗
氠	氣 申	气 申
氡	氣 冬	气 冬
氣	氣 米	气 米
氤	氣 因	气 因
氥	氣 西	气 西
氦	氣 亥	气 亥
氧	氣 羊	气 羊
氨	氣 安	气 安
氪	氣 克	气 克
氫	氣 巠	气 巠
氬	氣 亞	气 亞
氭	氣 東	气 東
氮	氣 炎	气 炎
氯	氣 彔	气 彔
氰	氣 青	气 青
氱	氣 昜	气 昜
氳	氣 昷	气 昷
水	乛 亅 丶 乀
氵	丶 丶 丿
氶	了 ㇆ 丶 乀
氷	丶 水
永	丶 一 水
氹	乙 水
氻	水 力	氵 力
氼	水 人
氽	人 水
氾	水 卩	氵 卩	水 㔾	氵 㔾
氿	水 九	氵 九
汀	水 丁	氵 丁
汁	水 十	氵 十
求	水 一 丶
汃	水 八	氵 八
汄	水 人	氵 人
汅	水 丂	氵 丂
汆	入 水
汈	水 刁	氵 刁
汊	水 叉	氵 叉
汋	水 勺	氵 勺
汌	水 川	氵 川
汍	水 丸	氵 丸
汎	水 凡	氵 凡
汏	水 大	氵 大
汐	水 夕	氵 夕
汑	水 乇	氵 乇
汒	水 亡	氵 亡
汓	水 子	氵 子
汔	水 乞	氵 乞
汕	水 山	氵 山
汖	山 水
汗	水 干	氵 干
汘	水 千	氵 千
汙	水 于	氵 于
汚	水 亐	氵 亐
汛	水 卂	氵 卂
汜	水 巳	氵 巳
汝	水 女	氵 女
汞	工 水
江	水 工	氵 工
池	水 也	氵 也
污	水 亏	氵 亏
汥	水 支	氵 支
汦	水 氏	氵 氏
汧	水 开	氵 开
汨	水 曰	氵 日
汩	水 日	氵 日
汪	水 王	氵 王
汫	水 井	氵 井
汬	井 水
汭	水 內	氵 內
汮	水 勻	氵 勻
汯	水 厷	氵 厷
汰	水 太	氵 太
汱	水 犬	氵 犬
汲	水 及	氵 及
汳	水 反	氵 反
汴	水 卞	氵 卞
汵	水 今	氵 今
汶	水 文	氵 文
汷	水 攴	氵 攵
汸	水 方	氵 方
決	水 夬	氵 夬
汻	水 午	氵 午
汽	水 氣	氵 气
汾	水 分	氵 分
汿	水 予	氵 予
沀	水 予
沁	水 心	氵 心
沂	水 斤	氵 斤
沃	水 夭	氵 夭
沅	水 元	氵 元
沆	水 亢	氵 亢
沇	水 允	氵 允
沈	水 冘	氵 冘
沊	冘 水
沌	水 屯	氵 屯
沍	水 互	氵 互
沎	水 化	氵 化
沏	水 切	氵 切
沐	水 木	氵 木
沑	水 丑	氵 丑
沒	水 勹 又	氵 勹 又
沓	水 日	氵 日
沔	水 丏	氵 丏
沕	水 勿	氵 勿
沖	水 中	氵 中
沗	天 水
沘	水 比	氵 比
沙	水 少	氵 少
沚	水 止	氵 止
沛	水 巿	氵 巿
沜	水 片	氵 片
沝	水 水
沞	水 帀	氵 帀
沠	水 爪	氵 爪
沢	水 尺	氵 尺
沣	水 丰	氵 丰
沫	水 末	氵 末
沬	水 未	氵 未
沭	水 朮	氵 朮
沮	水 且	氵 且
沯	水 石
沰	水 石	氵 石
沱	水 它	氵 它
沲	水 丿 一 也	氵 丿 一 也
河	水 可	氵 可
沴	水 人 彡	氵 人 彡
沶	水 示	氵 示
沷	水 犮	氵 犮
沸	水 弗	氵 弗
油	水 由	氵 由
沺	水 田	氵 田
治	水 台	氵 台
沼	水 召	氵 召
沽	水 古	氵 古
沾	水 占	氵 占
沿	水 八 口	氵 八 口
泀	水 司	氵 司
況	水 兄	氵 兄
泂	水 冋	氵 冋
泃	水 句	氵 句
泄	水 世	氵 世
泅	水 囚	氵 囚
泆	水 失	氵 失
泇	水 加	氵 加
泈	水 冬	氵 冬
泉	白 水
泊	水 白	氵 白
泋	水 卉	氵 卉
泌	水 必	氵 必
泍	水 本	氵 本
泎	水 乍	氵 乍
泏	水 出	氵 出
泐	水 阞	氵 阞
泑	水 幼	氵 幼
泒	水 瓜	氵 瓜
泓	水 弘	氵 弘
泔	水 甘	氵 甘
法	水 去	氵 去
泖	水 卯	氵 卯
泗	水 四	氵 四
泘	水 乎	氵 乎
泙	水 平	氵 平
泚	水 此	氵 此
泛	水 乏	氵 乏
泜	水 氐	氵 氐
泝	水 斥	氵 斥
泟	水 正	氵 正
泠	水 令	氵 令
泡	水 包	氵 包
波	水 皮	氵 皮
泣	水 立	氵 立
泤	水 以	氵 以
泥	水 尼	氵 尼
泦	水 尻	氵 尻
泧	水 戉	氵 戉
注	水 主	氵 主
泩	水 生	氵 生
泫	水 玄	氵 玄
泬	水 穴	氵 穴
泭	水 付	氵 付
泮	水 半	氵 半
泯	水 民	氵 民
泰	手 乀 水	龹 水
泱	水 央	氵 央
泲	水 丿 ㇉ 丨 丿	氵 丿 ㇉ 丨 丿	水 𠂔	氵 𠂔
泳	水 永	氵 永
泴	水 皿
泵	石 水
泿	水 艮	氵 艮
洀	水 舟	氵 舟
洂	水 亦	氵 亦
洃	水 灰	氵 灰
洄	水 回	氵 回
洅	水 再	氵 再
洆	水 丞	氵 丞
洇	水 因	氵 因
洈	水 危	氵 危
洉	水 后	氵 后
洊	水 存	氵 存
洋	水 羊	氵 羊
洌	水 列	氵 列
洎	水 自	氵 自
洏	水 而	氵 而
洐	水 行	氵 行
洑	水 伏	氵 伏
洓	水 朿	氵 朿
洔	水 寺	氵 寺
洕	水 八 肉	氵 水 八 肉	水 八 月	氵 八 月
洖	水 吳	氵 吳
洗	水 先	氵 先
洘	水 考	氵 考
洙	水 朱	氵 朱
洚	水 夅	氵 夅
洛	水 各	氵 各
洝	水 安	氵 安
洞	水 同	氵 同
洟	水 夷	氵 夷
洠	水 牟	氵 牟
洡	水 耒	氵 耒
洢	水 伊	氵 伊
洣	水 米	氵 米
洤	水 全	氵 全
津	水 聿	氵 聿
洦	水 百	氵 百
洧	水 有	氵 有
洨	水 交	氵 交
洩	水 曳	氵 曳
洪	水 共	氵 共
洫	水 血	氵 血
洬	水 夙	氵 夙
洭	水 匡	氵 匡
洮	水 兆	氵 兆
洯	水 丰 刀	氵 丰 刀
洰	水 巨	氵 巨
洱	水 耳	氵 耳
洲	水 州	氵 州
洳	水 如	氵 如
洴	水 并	氵 并	水 幷	氵 幷
洵	水 旬	氵 旬
洶	水 匈	氵 匈
洷	水 至	氵 至
洸	水 光	氵 光
洹	水 亘	氵 亘
洺	水 名	氵 名
活	水 舌	氵 舌
洽	水 合	氵 合
派	水 厂 氏	氵 厂 氏	水 𠂢	氵 𠂢
洿	水 夸	氵 夸
浀	水 曲	氵 曲
流	水 亠 厶 川	氵 亠 厶 川	氵 巟	水 㐬	氵 㐬
浂	水 关	氵 关
浄	水 争	氵 争
浖	水 寽	氵 寽
浗	水 求	氵 求
浘	水 尾	氵 尾
浙	水 折	氵 折
浚	水 夋	氵 夋
浛	水 含	氵 含
浜	水 兵	氵 兵
浝	水 尨	氵 尨
浞	水 足	氵 足
浟	水 攸	氵 攸
浠	水 希	氵 希
浡	水 孛	氵 孛
浢	水 豆	氵 豆
浣	水 完	氵 完
浤	水 宏	氵 宏
浥	水 邑	氵 邑
浦	水 甫	氵 甫
浧	水 呈	氵 呈
浨	水 宋	氵 宋
浩	水 告	氵 告
浪	水 良	氵 良
浫	水 罕	氵 罕
浬	水 里	氵 里
浭	水 更	氵 更
浮	水 孚	氵 孚
浯	水 吾	氵 吾
浰	水 利	氵 利
浱	水 辰	氵 辰
浲	水 夆	氵 夆
浳	水 弋 肉	氵 弋 肉	水 弋 月	氵 弋 月
浴	水 谷	氵 谷
浵	水 彤	氵 彤
浶	水 牢	氵 牢
海	水 每	氵 每
浸	水 彐 冖 又	氵 彐 冖 又
浹	水 夾	氵 夾
浺	水 忡	氵 忡
浻	水 冏	氵 冏
浼	水 免	氵 免
浽	水 妥	氵 妥
浾	水 赤	氵 赤
浿	水 貝	氵 貝
涀	水 見	氵 見
涁	水 杉	氵 杉
涂	水 余	氵 余
涃	水 困	氵 困
涄	水 甹	氵 甹
涅	水 圼	氵 圼
涆	水 旰	氵 旰
涇	水 巠	氵 巠
消	水 肖	氵 肖
涉	水 步	氵 步
涊	水 忍	氵 忍
涋	水 宊	氵 宊
涍	水 孝	氵 孝
涎	水 延	氵 延
涏	水 廷	氵 廷
涐	水 我	氵 我
涑	水 束	氵 束
涒	水 君	氵 君
涓	水 肙	氵 肙
涔	水 岑	氵 岑
涕	水 弟	氵 弟
涖	水 位	氵 位
涗	水 兌	氵 兌
涘	水 矣	氵 矣
涙	水 戻	氵 戻
涜	水 売	氵 売
涪	水 咅	氵 咅
涫	水 官	氵 官
涬	水 幸	氵 幸
涭	水 受	氵 受
涮	水 刷	氵 刷
涯	水 厓	氵 厓
涰	水 叕	氵 叕
涱	水 長	氵 長
液	水 夜	氵 夜
涳	水 空	氵 空
涴	水 宛	氵 宛
涵	水 函	氵 函
涶	水 垂	氵 垂
涷	水 東	氵 東
涸	水 固	氵 固
涹	水 委	氵 委
涺	水 居	氵 居
涻	水 舍	氵 舍
涼	水 京	氵 京
涽	水 昏	氵 昏
涾	水 沓	氵 沓
涿	水 豖	氵 豖
淁	水 妾	氵 妾
淂	水 日 一 寸	氵 日 一 寸	水 㝵	氵 㝵
淃	水 卷	氵 卷
淄	水 甾	氵 甾
淅	水 析	氵 析
淆	水 肴	氵 肴
淇	水 其	氵 其
淈	水 屈	氵 屈
淉	水 果	氵 果
淊	水 臽	氵 臽
淋	水 林	氵 林
淌	水 尚	氵 尚
淍	水 周	氵 周
淎	水 奉	氵 奉
淏	水 昊	氵 昊
淐	水 昌	氵 昌
淑	水 叔	氵 叔
淒	水 妻	氵 妻
淓	水 芳	氵 芳
淔	水 直	氵 直
淕	水 坴	氵 坴
淖	水 卓	氵 卓
淗	水 匊	氵 匊
淘	水 匋	氵 匋
淙	水 宗	氵 宗
淚	水 戾	氵 戾
淛	水 制	氵 制
淜	水 朋	氵 朋
淝	水 肥	氵 肥
淞	水 松	氵 松
淟	水 典	氵 典
淠	水 畀	氵 畀
淡	水 炎	氵 炎
淢	水 或	氵 或
淣	水 兒	氵 兒
淤	水 於	氵 於
淥	水 彔	氵 彔
淦	水 金	氵 金
淧	水 宓	氵 宓
淨	水 爭	氵 爭
淩	水 夌	氵 夌
淪	水 侖	氵 侖
淫	水 爪 壬	氵 爫 壬
淬	水 卒	氵 卒
淭	水 戶 木	氵 戶 木
淮	水 隹	氵 隹
淯	水 育	氵 育
淰	水 念	氵 念
深	水 罙	氵 罙
淲	水 虎	氵 虎
淳	水 享	氵 享
淴	水 忽	氵 忽
淵	水 片 一 爿	氵 片 一 爿
淶	水 來	氵 來
混	水 昆	氵 昆
淸	水 靑	氵 靑
淹	水 奄	氵 奄
淺	水 戔	氵 戔
添	水 忝	氵 忝
淼	水 水 水
淽	水 芷	氵 芷
淾	金 水
淿	水 帛	氵 帛
渀	水 奔	氵 奔
渁	水 水	氵 水
渂	水 旻	氵 旻
渃	水 若	氵 若
渄	水 非	氵 非
清	水 青	氵 青
渆	水 并 刀	氵 并 刂	洴 刀	洴 刂
渇	水 日 勹 匕	氵 日 勹 匕
済	水 斉	氵 斉
渉	水 歩	氵 歩
渒	水 卑	氵 卑
渕	水 关 刀	氵 关 刂	浂 刀	浂 刂
渘	水 柔	氵 柔
渙	水 奐	氵 奐
渚	水 者	氵 者
減	水 咸	氵 咸
渜	水 耎	氵 耎
渝	水 俞	氵 俞
渞	水 首	氵 首
渟	水 亭	氵 亭
渠	洰 木
渡	水 度	氵 度
渢	水 風	氵 風
渣	水 查	氵 查
渤	水 勃	氵 勃
渥	水 屋	氵 屋
渦	水 咼	氵 咼
渧	水 帝	氵 帝
渨	水 畏	氵 畏
渪	水 禹	氵 禹
渫	水 枼	氵 枼
測	水 則	氵 則
渭	水 胃	氵 胃
渮	水 荷	氵 荷
港	水 巷	氵 巷
渰	水 弇	氵 弇
渱	水 虹	氵 虹
渲	水 宣	氵 宣
渳	水 弭	氵 弭
渴	水 曷	氵 曷
渵	水 苗	氵 苗
渶	水 英	氵 英
渷	水 兗	氵 兗
游	水 斿	氵 斿
渹	水 訇	氵 訇
渺	水 目 少	氵 目 少
渻	水 省	氵 省
渼	水 美	氵 美
渽	水 哉	氵 哉
渾	水 軍	氵 軍
渿	水 奈	氵 奈
湀	水 癸	氵 癸
湁	水 拾	氵 拾
湂	水 咢	氵 咢
湃	水 拜	氵 拜
湄	水 眉	氵 眉
湅	水 柬	氵 柬
湆	水 音	氵 音
湇	水 立 肉	氵 立 肉	水 立 月	氵 立 月
湈	水 某	氵 某
湉	水 恬	氵 恬
湊	水 奏	氵 奏
湋	水 韋	氵 韋
湌	水 食	氵 食
湍	水 耑	氵 耑	水 山 而	氵 山 而
湎	水 面	氵 面
湏	水 頁	氵 頁
湐	水 柏	氵 柏
湑	水 胥	氵 胥
湒	水 咠	氵 咠
湓	水 盆	氵 盆
湔	水 前	氵 前
湕	水 建	氵 建
湖	水 胡	氵 胡
湗	水 封	氵 封
湘	水 相	氵 相
湙	水 奕	氵 奕
湚	水 胤	氵 胤
湛	水 甚	氵 甚
湜	水 是	氵 是
湝	水 皆	氵 皆
湞	水 貞	氵 貞
湟	水 皇	氵 皇
湠	水 炭	氵 炭
湡	水 禺	氵 禺
湢	水 畐	氵 畐
湣	水 昬	氵 昬
湤	水 施	氵 施
湥	水 突	氵 突
湦	水 星	氵 星
湧	水 勇	氵 勇
湨	水 狊	氵 狊
湩	水 重	氵 重
湫	水 秋	氵 秋
湬	秋 水
湮	水 垔	氵 垔
湯	水 昜	氵 昜
湰	水 夂 一 生	氵 夂 一 生
湱	水 砉	氵 砉
湲	水 爰	氵 爰
湳	水 南	氵 南
湴	水 並	氵 並
湵	水 羑	氵 羑
湶	水 泉	氵 泉
湷	水 春	氵 春
湸	水 亮	氵 亮
湹	水 厘	氵 厘
湺	水 保	氵 保
湻	水 亯	氵 亯
湼	水 臼 工	氵 臼 工
湽	水 甾 一	氵 甾 一
満	水 草 両	氵 艸 両	氵 艹 両
溆	水 叙	氵 叙
溈	水 為	氵 為
溉	水 既	氵 既
溌	水 発	氵 発
溍	水 晉	氵 晉
溎	水 桂	氵 桂
溏	水 唐	氵 唐
源	水 原	氵 原
溑	水 小 貝	氵 小 貝
溒	水 袁	氵 袁
溓	水 兼	氵 兼
溔	水 羔	氵 羔
溕	水 冡	氵 冡
準	水 隹 十	氵 隹 十
溗	水 乘	氵 乘
溘	水 盍	氵 盍
溙	水 泰	氵 泰
溚	水 荅	氵 荅
溛	水 窊	氵 窊
溜	水 留	氵 留
溝	水 冓	氵 冓
溞	水 蚤	氵 蚤
溟	水 冥	氵 冥
溠	水 差	氵 差
溡	水 時	氵 時
溢	水 益	氵 益
溣	水 侖	氵 侖
溤	水 馬	氵 馬
溥	水 尃	氵 尃
溦	水 山 兀 攴	氵 山 兀 攵
溧	水 栗	氵 栗
溨	水 栽	氵 栽
溩	水 烏	氵 烏
溪	水 奚	氵 奚
溫	水 昷	氵 昷
溬	水 羗	氵 羗
溭	水 畟	氵 畟
溮	水 師	氵 師
溯	水 朔	氵 朔
溰	水 豈	氵 豈
溱	水 秦	氵 秦
溲	水 叟	氵 叟
溳	水 員	氵 員
溴	水 臭	氵 臭
溵	水 殷	氵 殷
溶	水 容	氵 容
溷	水 圂	氵 圂
溸	水 素	氵 素
溹	水 索	氵 索
溺	水 弱	氵 弱
溻	水 日 羽	氵 日 羽
溼	水 一 幺 幺 土	氵 一 幺 幺 土
溽	水 辱	氵 辱
溾	水 鬼	氵 鬼
溿	水 畔	氵 畔
滀	水 畜	氵 畜
滁	水 除	氵 除
滂	水 旁	氵 旁
滃	水 翁	氵 翁
滄	水 倉	氵 倉
滅	水 戊 一 火	氵 戊 一 火	水 烕	氵 烕
滆	水 鬲	氵 鬲
滇	水 真	氵 真
滈	水 高	氵 高
滉	水 晃	氵 晃
滊	水 氣	氵 氣
滋	水 兹	氵 兹
滌	水 條	氵 條
滍	水 蚩	氵 蚩
滎	火 火 冖 水	𤇾 水
滏	水 釜	氵 釜
滑	水 骨	氵 骨
滒	水 哥	氵 哥
滓	水 宰	氵 宰
滔	水 舀	氵 舀
滕	水 丷 夫 水	氵 丷 夫 水	水 𠔉 水	氵 𠔉 水
滖	水 衰	氵 衰
滘	水 冖 八 工 口	氵 冖 八 工 口	水 㓁 工 口
滙	水 匚 隹	氵 匚 隹
滛	水 爪 缶	氵 爫 缶
滜	水 皋	氵 皋
滝	水 竜	氵 竜
滣	水 唇	氵 唇
滫	水 脩	氵 脩
滬	水 戶 邑	氵 戶 邑
滭	水 畢	氵 畢
滮	水 彪	氵 彪
滯	水 帶	氵 帶
滰	水 竟	氵 竟
滱	水 寇	氵 寇
滲	水 參	氵 參
滳	水 商	氵 商
滴	水 啇	氵 啇
滵	水 密	氵 密
滶	水 敖	氵 敖
滷	水 鹵	氵 鹵
滸	水 許	氵 許
滹	水 虖	氵 虖
滺	水 悠	氵 悠
滻	水 產	氵 產
滼	水 梵	氵 梵
滽	水 庸	氵 庸
滾	水 袞	氵 袞
滿	水 廿 冂 丨 入 入	氵 廿 冂 丨 入 入	水 㒼	氵 㒼
漀	殸 水
漁	水 魚	氵 魚
漂	水 票	氵 票
漃	水 寂	氵 寂
漄	水 崖	氵 崖
漅	水 巢	氵 巢
漆	水 桼	氵 桼
漇	水 徙	氵 徙
漈	水 祭	氵 祭
漉	水 鹿	氵 鹿
漊	水 婁	氵 婁
漋	水 隆	氵 隆
漌	水 堇	氵 堇
漍	水 國	氵 國
漎	水 從	氵 從
漏	水 屚	氵 屚
漐	執 水
漑	水 旣	氵 旣
漒	水 強	氵 強
漓	水 离	氵 离
演	水 寅	氵 寅
漕	水 曹	氵 曹
漖	水 教	氵 教
漗	水 悤	氵 悤
漘	水 脣	氵 脣
漙	水 專	氵 專
漚	水 區	氵 區
漛	水 丷 夫 水	氵 丷 夫 水	水 𠔉 水
漜	水 埜	氵 埜
漝	水 習	氵 習
漞	水 覓	氵 覓
漟	水 堂	氵 堂
漠	水 莫	氵 莫
漡	水 丿 一 昜	氵 丿 一 昜
漢	水 革 大	氵 革 大
漣	水 連	氵 連
漤	水 婪	氵 婪
漥	水 穴 圭	氵 穴 圭
漦	未 攵 厂 水
漧	水 乾	氵 乾
漨	水 逢	氵 逢
漩	水 旋	氵 旋
漪	水 犬 奇	氵 犭 奇
漫	水 曼	氵 曼
漬	水 責	氵 責
漭	水 莽	氵 莽
漮	水 康	氵 康
漯	水 累	氵 累
漰	水 崩	氵 崩
漱	水 欶	氵 欶
漲	水 張	氵 張
漳	水 章	氵 章
漴	水 崇	氵 崇
漵	水 敘	氵 敘
漶	水 患	氵 患
漷	水 郭	氵 郭
漸	水 斬	氵 斬
漹	水 焉	氵 焉
漺	水 爽	氵 爽
漻	水 翏	氵 翏
漼	水 崔	氵 崔
漽	水 犀	氵 犀
漾	水 羕	氵 羕
漿	水 將
潀	水 眾	氵 眾
潁	匕 水 頁
潂	水 山 並	氵 山 並
潃	水 彳 攵 肉	氵 彳 攵 肉	水 彳 攵 月	氵 彳 攵 月
潄	水 敕	氵 敕
潅	水 丿 二 隹	氵 丿 二 隹
潊	水 敍	氵 敍
潌	水 窒	氵 窒
潎	水 敝	氵 敝
潏	水 矞	氵 矞
潐	水 焦	氵 焦
潑	水 發	氵 發
潒	水 象	氵 象
潓	水 惠	氵 惠
潔	水 絜	氵 絜
潕	水 無	氵 無
潖	水 琶	氵 琶
潗	水 集	氵 集
潘	水 番	氵 番
潙	水 爲	氵 爲
潚	水 肅	氵 肅
潛	水 朁	氵 朁
潝	水 翕	氵 翕
潞	水 路	氵 路
潟	水 臼 勹 火	氵 臼 勹 灬
潠	水 巽	氵 巽
潡	水 敦	氵 敦
潢	水 黃	氵 黃
潣	水 閔	氵 閔
潤	水 閏	氵 閏
潥	水 粟	氵 粟
潦	水 尞	氵 尞
潧	水 曾	氵 曾
潨	水 衆	氵 衆
潩	水 異	氵 異
潪	水 智	氵 智
潫	水 絭	氵 絭
潬	水 單	氵 單
潭	水 覃	氵 覃
潮	水 朝	氵 朝
潯	水 尋	氵 尋
潰	水 貴	氵 貴
潲	水 稍	氵 稍
潳	水 屠	氵 屠
潵	水 散	氵 散
潶	水 黑	氵 黑
潷	水 筆	氵 筆
潸	水 木 木 月	氵 木 木 月
潹	水 森	氵 森
潺	水 孱	氵 孱
潻	水 黍	氵 黍
潼	水 童	氵 童
潽	水 普	氵 普
潾	水 粦	氵 粦
潿	水 圍	氵 圍
澀	水 歰	氵 歰
澁	水 歮	氵 歮
澂	水 山 一 王 攴	氵 彳 山 一 王 攵 徴
澃	須 水
澄	水 登	氵 登
澅	水 畫	氵 畫
澆	水 堯	氵 堯
澇	水 勞	氵 勞
澈	水 育 攵	氵 育 攵
澉	水 敢	氵 敢
澊	水 尊	氵 尊
澋	水 景	氵 景
澌	水 斯	氵 斯
澍	水 尌	氵 尌
澎	水 彭	氵 彭
澏	水 喦	氵 喦
澐	水 雲	氵 雲
澑	水 畱	氵 畱
澒	水 項	氵 項
澓	水 復	氵 復
澔	水 皓	氵 皓
澕	水 華	氵 華
澖	水 閑	氵 閑
澗	水 間	氵 間
澘	水 林 日	氵 林 日
澙	水 舃	氵 舃
澞	水 虞	氵 虞
澟	水 稟	氵 稟
澠	水 黽	氵 黽
澡	水 品 木	氵 品 木	氵 喿
澢	水 當	氵 當
澣	水 幹	氵 幹
澤	水 睪	氵 睪
澥	水 解	氵 解
澦	水 預	氵 預
澧	水 豊	氵 豊
澨	水 筮	氵 筮
澩	臼 爻 冖 水	𦥯 水
澪	水 零	氵 零
澫	水 萬	氵 萬
澬	水 資	氵 資
澭	水 雍	氵 雍
澮	水 會	氵 會
澯	水 粲	氵 粲
澰	水 僉	氵 僉
澱	水 殿	氵 殿
澲	水 業	氵 業
澳	水 奧	氵 奧
澴	水 睘	氵 睘
澵	水 新	氵 新
澶	水 亶	氵 亶
澷	水 曰 网 方	氵 曰 罒 方
澸	水 感	氵 感
澹	水 詹	氵 詹
澺	水 意	氵 意
澻	水 遂	氵 遂
澼	水 辟	氵 辟
澽	水 豦	氵 豦
澾	水 達	氵 達
澿	水 禁	氵 禁
激	水 敫	氵 敫
濁	水 蜀	氵 蜀
濂	水 廉	氵 廉
濃	水 農 膿	氵 農 膿
濄	水 過	氵 過
濅	水 宀 帚 又	氵 宀 帚 又
濆	水 賁	氵 賁
濇	水 嗇	氵 嗇
濈	水 戢	氵 戢
濉	水 睢	氵 睢
濊	水 歲	氵 歲
濋	水 楚	氵 楚
濌	重 沓
濍	水 葱	氵 葱
濎	水 鼎	氵 鼎
濐	水 暑	氵 暑
濓	水 亷	氵 亷
濔	水 爾	氵 爾
濕	水 日 幺 幺 火	氵 日 幺 幺 灬	水 㬎	氵 㬎
濖	水 署	氵 署
濗	水 幕	氵 幕
濘	水 寧	氵 寧
濙	水 熒	氵 熒
濚	水 榮	氵 榮
濛	水 蒙	氵 蒙
濜	水 盡	氵 盡
濝	水 綦	氵 綦
濞	水 鼻	氵 鼻
濟	水 齊	氵 齊
濠	水 豪	氵 豪
濡	水 需	氵 需
濢	水 翠	氵 翠
濣	水 斡	氵 斡
濤	水 壽	氵 壽
濥	水 夤	氵 夤
濦	水 爪 工 彐 心	氵 爫 工 彐 心	水 㥯	氵 㥯
濧	水 對	氵 對
濨	水 慈	氵 慈
濩	水 蒦	氵 蒦
濪	水 靘	氵 靘
濫	水 監	氵 監
濬	水 睿	氵 睿
濭	水 蓋	氵 蓋
濮	水 僕	氵 僕
濯	水 翟	氵 翟
濰	水 維	氵 維
濱	水 賓	氵 賓
濲	水 穀	氵 穀
濳	水 先 先 曰	氵 先 先 曰	水 先 先 日	氵 先 先 日
濴	水 滎	氵 滎
濶	水 門 舌	氵 門 舌
濷	水 滿
濺	水 賤	氵 賤
濻	水 隤	氵 隤
濼	水 樂	氵 樂
濽	水 賛	氵 賛
濾	水 慮	氵 慮
濿	水 厲	氵 厲
瀀	水 憂	氵 憂
瀁	水 養	氵 養
瀂	水 魯	氵 魯
瀃	水 賜	氵 賜
瀄	水 節	氵 節
瀅	水 瑩	氵 瑩
瀆	水 賣	氵 賣
瀇	水 廣	氵 廣
瀈	水 翬	氵 翬
瀉	水 寫	氵 寫
瀊	水 盤	氵 盤
瀋	水 審	氵 審
瀋	水 審	氵 審
瀌	水 麃	氵 麃
瀍	水 廛	氵 廛
瀎	水 蔑	氵 蔑
瀏	水 卯 金 刀	氵 卯 金 刂
瀐	水 韯	氵 韯
瀑	水 暴	氵 暴
瀒	水 來 一 回	氵 來 一 回
瀓	水 徵	氵 徵
瀕	水 頻	氵 頻
瀖	水 霍	氵 霍
瀗	水 憲	氵 憲
瀘	水 盧	氵 盧
瀙	水 親	氵 親
瀚	水 翰	氵 翰
瀛	水 嬴	氵 嬴
瀜	水 融	氵 融
瀝	水 歷	氵 歷
瀞	水 静	氵 静
瀟	水 蕭	氵 蕭
瀠	水 縈	氵 縈
瀡	水 隨	氵 隨
瀢	水 遺	氵 遺
瀣	水 韰	氵 韰
瀤	水 褱	氵 褱
瀥	水 翯	氵 翯
瀦	水 豬	氵 豬
瀧	水 龍	氵 龍
瀨	水 賴	氵 賴
瀩	水 頹	氵 頹
瀪	敏 泉
瀫	水 縠	氵 縠
瀬	水 頼	氵 頼
瀯	水 營	氵 營
瀰	水 彌	氵 彌
瀱	水 罽	氵 罽
瀲	水 斂	氵 斂
瀳	水 薦	氵 薦
瀴	水 嬰	氵 嬰
瀵	水 糞	氵 糞
瀶	水 臨	氵 臨
瀷	水 翼	氵 翼
瀸	水 韱	氵 韱
瀹	水 龠	氵 龠
瀺	水 毚	氵 毚
瀻	水 戴	氵 戴
瀼	水 襄	氵 襄
瀽	水 蹇	氵 蹇
瀾	水 闌	氵 闌
瀿	水 繁	氵 繁
灀	水 霜	氵 霜
灁	水 門 泉	氵 門 泉
灂	水 爵	氵 爵
灃	水 豐	氵 豐
灄	水 聶	氵 聶
灅	水 壘	氵 壘
灆	水 藍	氵 藍
灇	水 叢	氵 叢
灈	水 瞿	氵 瞿
灉	水 雝	氵 雝
灊	水 鬵	氵 鬵
灌	水 雚	氵 雚
灍	水 闕	氵 闕
灎	水 豊 盍	氵 豊 盍
灑	水 麗	氵 麗
灒	水 贊	氵 贊
灓	絲 言 水	糸 言 糸 水	䜌 水
灔	水 艶	氵 艶
灕	水 離	氵 離
灖	水 靡	氵 靡
灗	水 蟺	氵 蟺
灘	水 難	氵 難
灙	水 黨	氵 黨
灚	水 覺	氵 覺
灛	水 闡	氵 闡
灝	水 顥	氵 顥
灞	水 霸	氵 霸
灟	水 屬	氵 屬
灠	水 覽	氵 覽
灡	水 蘭	氵 蘭
灢	水 囊	氵 囊
灣	水 彎	氵 水 彎
灤	水 欒	氵 欒
灥	泉 泉 泉
灦	水 顯	氵 顯
灧	水 艷	氵 艷
灩	水 豔	氵 豔
灪	水 鬱	氵 鬱
火	丷 人
灬	丶 丶 丶 丶
灮	火 儿
灰	厂 火	一 丿 火
灱	火 刀
灲	火 刀	火 刂
灴	火 工
灶	火 土
灷	火 廾
灸	久 火
灹	火 乇
灺	火 也
灻	土 火
灼	火 勺
災	巛 火
炁	旡 火	旡 灬
炂	火 公
炃	分 火
炄	火 丑
炅	日 火
炆	火 文
炇	火 攴	火 攵
炈	火 殳
炊	火 欠
炋	火 不
炌	火 介
炍	火 反
炎	火 火
炏	火 火
炐	火 丰
炑	火 木
炒	火 少
炓	火 斗
炔	火 夬
炕	火 亢
炗	廿 火
炘	火 斤
炙	肉 火	月 火
炛	火 化
炟	火 旦
炠	火 甲
炡	火 正
炢	火 术
炣	火 可
炤	火 召
炥	火 弗
炦	火 犮
炧	火 丿 一 也
炨	火 它
炩	火 令
炪	火 出
炫	火 玄
炬	火 巨
炭	山 灰	山 厂 火
炮	火 包
炯	火 冋
炰	包 火	包 灬
炱	台 火
炲	火 台
炳	火 丙
炴	火 央
炵	火 冬
炶	火 占
炷	火 主
炸	火 乍
為	丶 丿 ㇆ ㇆ ㇆ 火	丶 丿 ㇆ ㇆ ㇆ 灬
炻	火 石
炾	火 兄
烀	火 乎
烄	火 交
烅	火 血
烆	火 行
烇	火 全
烈	列 火	列 灬
烉	刀 冂 八 火
烊	火 羊
烋	休 火	休 灬
烌	火 休
烍	火 先
烎	干 干 火	开 火
烏	户 一 ㇆ 火	户 一 ㇆ 灬
烐	火 舟
烑	火 兆
烒	火 式
烓	火 圭
烔	火 同
烕	戊 一 火
烖	十 戈 火	土 戈 火	𢦏 火
烗	火 亥
烘	火 共
烙	火 各
烚	火 合
烜	火 亘
烝	丞 火	丞 灬
烞	火 朴
烠	火 有
烡	火 共
烢	火 宅
烣	火 灰
烤	火 考
烯	火 希
烰	火 孚
烱	火 冏
烲	折 火
烳	火 甫
烴	火 巠
烵	火 勺
烶	火 廷
烷	火 完
烸	火 每
烹	亨 火	亨 灬
烺	火 良
烻	火 延
烼	火 豕
烽	火 夆
烾	炎 土
烿	火 彤
焀	火 谷
焂	攸 火
焃	火 赤
焄	君 火	君 灬
焅	火 告
焆	火 肙
焇	火 肖
焈	戶 已	户 已
焉	正 一 勹 火	正 一 勹 灬
焊	火 旱
焋	壯 火	壯 灬
焌	火 夋
焍	火 弟
焎	折 火	折 灬
焏	了 口 又 火	了 口 又 灬
焐	火 吾
焓	火 含
焔	火 刀 旧
焗	火 局
焙	火 咅
焚	林 火
焛	門 火
焜	火 昆
焝	火 昏
焞	火 享
焟	火 昔
焠	火 卒
無	丿 一 卌 一 火	丿 一 卌 一 灬	丿 一 一 丨 丨 丨 丨 一 火
焢	火 空
焣	取 火	取 灬
焤	府 火
焥	火 宛
焦	隹 火	隹 灬
焧	火 忩
焨	火 冐
焩	火 朋
焪	火 穹
焫	火 芮
焬	火 易
焭	火 火 冖 几	𤇾 几
焮	火 欣
焯	火 卓
焰	火 臽
焱	火 火 火
焲	火 夜
焳	火 隹
焴	火 育
焵	火 岡
然	肉 犬 火	月 犬 灬
焷	火 卑
焸	日 日 火
焺	火 昇
焻	火 昌
焼	火 尭
煁	火 甚
煂	火 革
煃	火 奎
煄	火 重
煅	火 段
煆	火 叚
煇	火 軍
煈	火 風
煉	火 柬
煊	火 宣
煋	火 星
煌	火 皇
煍	火 秋
煎	前 火	前 灬
煏	火 畐
煐	火 英
煑	者 火
煒	火 韋
煓	火 耑
煔	炎 占
煕	巸 火	巸 灬
煖	火 爰
煗	火 耎
煘	火 咸
煙	火 垔
煚	昛 火
煛	目 目 火
煜	火 日 立
煝	火 眉
煞	刍 攴 火	刍 攵 灬
煟	火 胃
煠	火 枼
煡	火 建
煢	火 火 冖 卂	𤇾 卂
煣	火 柔
煤	火 某
煥	火 奐
煦	昫 火	昫 灬
照	日 召 火	日 召 灬
煨	火 畏
煩	火 頁
煪	火 酋
煫	火 丷 豕
煬	火 昜
煭	巛 列 火	巛 列 灬
煮	者 火	者 灬
煰	火 品
煱	火 咼
煲	保 火
煳	火 胡
煵	火 南
煸	火 扁
煹	火 冓
煺	火 退
煻	火 唐
煼	火 芻
煽	火 扇
煾	火 恩
煿	火 尃
熀	火 晃
熁	火 脅
熂	火 氣
熃	務 火
熄	火 息
熅	火 昷
熆	火 盍
熇	火 高
熈	丿 熙
熉	火 員
熊	能 火	能 灬
熋	能 火
熌	火 閃
熎	爪 缶	爫 缶
熏	丿 一 黑	丿 一 里 丷 火	丿 一 里 丷 灬
熐	火 冥
熑	火 兼
熒	火 火 冖 火	𤇾 火
熓	火 烏
熔	火 容
熗	火 倉
熘	火 留
熙	巸 火	巸 灬
熚	火 畢
熛	火 票
熜	火 悤
熝	火 鹿
熞	火 堅
熟	孰 火	孰 灬
熠	火 習
熡	火 婁
熢	火 逢
熣	火 崔
熤	火 翌
熥	火 通
熦	火 雀
熧	從 火
熨	尉 火
熩	火 扈
熪	火 移
熫	火 庶
熬	敖 火
熭	彗 火
熮	火 翏
熯	火 革 大
熰	火 區
熱	埶 灬	執 火
熲	匕 火 頁
熳	火 曼
熵	火 商
熶	火 最
熷	火 曾
熸	火 旡 旡 日	火 朁
熹	喜 火	喜 灬
熺	火 喜
熻	火 翕
熼	火 異
熽	火 肅
熾	火 戠
熿	火 黃
燀	火 單
燁	火 華
燂	火 覃
燃	火 然
燄	臽 炎
燅	埶 炎
燆	火 喬
燇	火 尊
燈	火 登
燉	火 敦
燊	焱 木	火 火 火 木
燋	火 焦
燌	火 賁
燍	火 斯
燎	火 尞
燏	火 矞
燐	火 粦
燑	火 童
燒	火 堯
燓	棥 火	木 爻 木 火
燔	火 番
燕	廿 北 口 火	廿 北 口 灬
燖	火 尋
燗	火 閒
燘	火 閔
燙	湯 火
燚	火 火 火 火
燛	臦 火
燜	火 悶
營	火 火 冖 呂	𤇾 呂
燠	火 奧
燡	火 睪
燢	臼 爻 冖 火	𦥯 火
燣	火 稟
燤	火 萬
燥	火 品 木	火 喿
燦	火 粲
燧	火 遂
燨	火 義
燩	火 敫
燪	火 葱
燫	火 廉
燬	火 毀
燭	火 蜀
燮	火 言 火 又
燯	火 零
燰	火 愛
燱	火 意
燲	火 劦 貝
燳	火 照
燴	火 會
燶	火 農
燸	火 需
燹	豕 豕 火
燺	火 槀
燻	火 熏
燼	火 盡
燽	火 壽
燾	壽 火	壽 灬
燿	火 翟
爀	火 赫
爁	火 監
爂	臼 同 冖 火
爃	火 榮
爄	火 厲
爅	火 墨
爆	火 暴
爇	蓺 火	蓺 灬	草 熱	艸 熱	艹 熱
爈	火 慮
爉	火 巤
爊	火 麃
爋	火 勳
爌	火 廣
爍	火 樂
爏	火 歷
爐	火 盧
爑	火 蕉
爒	炙 尞
爓	火 閻
爔	火 羲
爕	火 言 火 火
爖	火 龍
爗	火 曅
爙	火 襄
爚	火 火 龠
爛	火 闌
爜	火 叢
爝	火 爵
爞	火 蟲
爟	火 雚
爡	火 蠆
爢	靡 火	靡 灬
爣	火 黨
爤	火 蘭
爥	火 屬
爧	火 靈
爨	臼 同 冖 林 大 火
爩	火 鬱
爪	厂 丨 乀
爫	丿 小	丿 丶 丶 丶
爬	爪 巴
爭	爪 聿	爫 肀
爮	爪 包
爯	爪 冉	爫 冉
爰	爪 一 友	爫 一 友
爲	爪 ㇆ ㇆ ㇆ 火 丿	爫  ㇆ ㇆ ㇆ 灬 丿
爴	國 爪
爵	爪 聿 爭 爭	爫 肀 爭
父	八 乂
爸	父 巴
爹	父 多
爺	父 耶
爻	乂 乂
爼	爻 且
爽	大 爻 爻	大 乂 乂 乂 乂
爾	一 八 冂 丨 爻 爻
爿	丨 一 丨 一 丿 
牀	爿 木
牁	爿 可
牂	爿 羊
牃	爿 枼
牄	爿 倉
牅	爿 庸
牆	爿 嗇
片	丄 丿 ㇆
版	片 反
牉	片 半
牊	片 召
牋	片 戔
牌	片 卑
牎	片 怱
牏	片 俞
牐	片 臿
牑	片 扁
牒	片 枼
牓	片 旁
牔	片 尃
牕	片 悤
牖	片 戶 甫
牘	片 賣
牙	丅 一 亅 丿
牚	尚 牙
牛	丿 一 十
牜	丿 十 丿
牝	牛 匕	牜 匕
牞	牛 力	牜 力
牟	厶 牛
牠	牛 也	牜 也
牡	牛 土	牜 土
牢	宀 牛
牣	牛 刃	牜 刃
牤	牛 亡	牜 亡
牥	牛 方	牜 方
牧	牛 攴	牜 攵
牨	牛 亢	牜 亢
物	牛 勿	牜 勿
牪	牛 牛
牫	牛 戈	牜 戈
牬	牛 丿 ㇉ 丨 丿	牜 丿 ㇉ 丨 丿	牛 𠂔	牜 𠂔
牭	牛 四	牜 四
牮	代 牛
牯	牛 古	牜 古
牰	牛 由	牜 由
牱	牛 可	牜 可
牲	牛 生	牜 生
牳	牛 母	牜 母
牴	牛 氐	牜 氐
牶	丷 夫 牛	𠔉 牛
牷	牛 全	牜 全
牸	牛 字	牜 字
特	牛 寺	牜 寺
牻	牛 尨	牜 尨
牼	牛 巠	牜 巠
牽	玄 冖 牛
牾	牛 吾	牜 吾
牿	牛 告	牜 告
犀	尸 二 丨 二 牛
犁	利 牛
犂	禾 丿 刀 牛
犃	牛 咅	牜 咅
犄	牛 奇	牜 奇
犅	牛 岡	牜 岡
犆	牛 直	牜 直
犇	牛 牛 牛
犈	牛 卷	牜 卷
犉	牛 享	牜 享
犋	牛 具	牜 具
犌	牛 叚	牜 叚
犍	牛 建	牜 建
犎	封 牛
犏	牛 扁	牜 扁
犐	牛 科	牜 科
犑	牛 狊	牜 狊
犒	牛 高	牜 高
犓	牛 芻	牜 芻
犔	牛 氣	牜 氣
犕	牛 人 草 厂 用	牜 艹 厂 用	牛 井 厂 用
犖	火 火 冖 牛	𤇾 牛
犗	牛 害	牜 害
犘	麻 牛
犙	牛 參	牜 參
犚	尉 牛
犛	未 攴 厂 牛	未 攵 厂 牛
犜	牛 敦	牜 敦
犝	牛 童	牜 童
犟	强 牛
犡	牛 厲	牜 厲
犢	牛 賣	牜 賣
犣	牛 巤	牜 巤
犤	牛 罷	牜 罷
犥	牛 麃	牜 麃
犦	牛 暴	牜 暴
犧	牛 羲	牜 羲
犨	雔 牛	隹 隹 牛
犩	魏 牛
犪	牛 夔	牜 夔
犫	讎 牛	隹 言 隹 牛
犬	大 丶
犭	丶 亅 丿
犮	一 丿 丶 又	一 丿 丶 乂
犯	犬 卩	犭 卩	犬 㔾	犭 㔾
犰	犬 九	犭 九
犱	犬 丸	犭 丸
犲	犬 才	犭 才
犳	犬 勺	犭 勺
犴	犬 干	犭 干
犵	犬 乞	犭 乞
犺	犬 亢	犭 亢
犻	犬 巿	犭 巿
犼	犬 孔	犭 孔
犽	犬 牙	犭 牙
犾	犬 犬	犭 犬
犿	犬 卞	犭 卞
狀	爿 犬
狁	犬 允	犭 允
狂	犬 王	犭 王
狃	犬 丑	犭 丑
狄	犬 火	犭 火
狅	犬 壬	犭 壬
狆	犬 中	犭 中
狇	犬 木	犭 木
狉	犬 丕	犭 丕
狊	目 犬
狋	犬 示	犭 示
狌	犬 生	犭 生
狍	犬 包	犭 包
狎	犬 甲	犭 甲
狏	犬 丿 一 也	犭 丿 一 也
狐	犬 瓜	犭 瓜
狑	犬 令	犭 令
狒	犬 弗	犭 弗
狓	犬 皮	犭 皮
狔	犬 尼	犭 尼
狕	犬 幼	犭 幼
狖	犬 穴	犭 穴
狗	犬 句	犭 句
狘	犬 戉	犭 戉
狙	犬 且	犭 且
狚	犬 旦	犭 旦
狛	犬 白	犭 白
狜	犬 古	犭 古
狟	犬 亘	犭 亘
狠	犬 艮	犭 艮
狡	犬 交	犭 交
狢	犬 各	犭 各
狣	犬 兆	犭 兆
狤	犬 吉	犭 吉
狥	犬 旬	犭 旬
狦	犬 冊 一	犭 冊 一	犬 冄 丨 丨	犭 冄 丨 丨
狧	犬 舌	犭 舌
狨	犬 戎	犭 戎
狩	犬 守	犭 守
狪	犬 同	犭 同
狫	犬 老	犭 老
狳	犬 余	犭 余
狴	犬 比 土	犭 比 土
狵	犬 尨	犭 尨
狶	犬 希	犭 希
狷	犬 肙	犭 肙
狸	犬 里	犭 里
狹	犬 夾	犭 夾
狺	犬 言	犭 言
狻	犬 夋	犭 夋
狼	犬 良	犭 良
狽	犬 貝	犭 貝
狾	犬 折	犭 折
狿	犬 延	犭 延
猀	犬 沙	犭 沙
猁	犬 利	犭 利
猂	犬 旱	犭 旱
猄	犬 京	犭 京
猅	犬 非	犭 非
猆	非 犬
猇	犬 虎	犭 虎
猈	犬 卑	犭 卑
猉	犬 其	犭 其
猊	犬 兒	犭 兒
猋	犬 犬 犬
猌	來 犬
猍	犬 來	犭 來
猏	犬 肩	犭 肩
猐	犬 羌	犭 羌
猑	犬 昆	犭 昆
猒	冐 犬	日 肉 犬	日 月 犬
猓	犬 果	犭 果
猔	犬 宗	犭 宗
猖	犬 昌	犭 昌
猗	犬 奇	犭 奇
猘	犬 制	犭 制
猙	犬 爭	犭 爭
猚	犬 隹	犭 隹
猛	犬 孟	犭 孟
猜	犬 青	犭 靑
猝	犬 卒	犭 卒
猞	犬 舍	犭 舍
猢	犬 胡	犭 胡
猣	犬 凶 八 夕	犭 凶 八 夕	犬 凶 八 夂	犭 凶 八 夂
猤	犬 癸	犭 癸
猥	犬 畏	犭 畏
猦	犬 風	犭 風
猧	犬 咼	犭 咼
猨	犬 爰	犭 爰
猩	犬 星	犭 星
猭	犬 彖	犭 彖
猯	犬 耑	犭 耑
猰	犬 契	犭 契
猱	犬 柔	犭 柔
猲	犬 葛	犭 葛
猳	犬 叚	犭 叚
猴	犬 侯	犭 侯
猵	犬 扁	犭 扁
猶	犬 酋	犭 酋
猷	酋 犬
猸	犬 眉	犭 眉
猹	犬 查	犭 查
猺	犬 月 缶	犭 月 缶	犬 䍃	犭 䍃
猻	犬 孫	犭 孫
猼	犬 尃	犭 尃
猽	犬 冥	犭 冥
猾	犬 骨	犭 骨
猿	犬 袁	犭 袁
獀	犬 叟	犭 叟
獁	犬 馬	犭 馬
獂	犬 原	犭 原
獃	豈 犬
獄	犬 言 犬	犭 訁 犬
獅	犬 師	犭 師
獆	犬 皋	犭 皋
獈	犬 益	犭 益
獉	犬 秦	犭 秦
獊	犬 倉	犭 倉
獋	犬 臯	犭 臯
獌	犬 曼	犭 曼
獍	犬 竟	犭 竟
獎	將 犬
獐	犬 章	犭 章
獑	犬 斬	犭 斬
獒	敖 犬
獓	犬 敖	犭 敖
獔	犬 皐	犭 皐
獕	犬 崔	犭 崔
獖	犬 賁	犭 賁
獗	犬 厥	犭 厥
獘	敝 犬
獙	犬 敝	犭 敝
獚	犬 黃	犭 黃
獛	犬 菐	犭 菐
獜	犬 粦	犭 粦
獝	犬 矞	犭 矞
獞	犬 童	犭 童
獟	犬 堯	犭 堯
獠	犬 尞	犭 尞
獡	犬 舄	犭 舄
獢	犬 喬	犭 喬
獥	犬 敫	犭 敫
獦	犬 葛	犭 葛
獧	犬 睘	犭 睘
獨	犬 蜀	犭 蜀
獩	犬 歲	犭 歲
獪	犬 會	犭 會
獫	犬 僉	犭 僉
獬	犬 解	犭 解
獮	犬 爾	犭 爾
獯	犬 熏	犭 熏
獰	犬 寧	犭 寧
獱	犬 賓	犭 賓
獲	犬 蒦	犭 蒦	犬 草 隹 又
獳	犬 需	犭 需
獴	犬 蒙	犭 蒙
獵	犬 巤	犭 巤
獶	犬 憂	犭 憂
獷	犬 廣	犭 廣
獸	嘼 犬
獹	犬 盧	犭 盧
獺	犬 賴	犭 賴
獻	虎 鬲 犬	虍 鬲 犬
獼	犬 彌
獽	犬 襄	犭 襄
獿	犬 夒	犭 夒
玀	犬 羅	犭 羅
玁	犬 嚴	犭 嚴
玂	犬 蕇 斤	犭 蕇 斤	犬 蘄	犭 蘄
玃	犬 矍	犭 矍
玄	亠 幺
玅	玄 少
玆	玄 玄
率	玄 冰 丶 丶 十	玄 冫 丶 丶 十
玈	玄 丿 一 氏
玉	王 丶
玊	王 丶
王	一 土	一 一 丨 一	二 十	三 丨	二 丄
玌	玉 乚	王 乚
玍	丿 王	午 一
玎	玉 丁	王 丁
玏	玉 力	王 力
玐	玉 八	王 八
玒	玉 工	王 工
玓	玉 勺	王 勺
玔	玉 川	王 川
玕	玉 干	王 干
玖	玉 久	王 久
玗	玉 于	王 于
玘	玉 己	王 己
玜	玉 公	王 公
玝	玉 午	王 午
玞	玉 夫	王 夫
玟	玉 文	王 文
玠	玉 介	王 介
玡	玉 牙	王 牙
玢	玉 分	王 分
玣	玉 卞	王 卞
玤	玉 丰	王 丰
玥	玉 月	王 月
玦	玉 夬	王 夬
玧	玉 允	王 允
玨	玉 王	王 王
玩	玉 元	王 元
玪	玉 今	王 今
玫	玉 攴	王 攵
玬	玉 丹	王 丹
玭	玉 比	王 比
玲	玉 令	王 令
玳	玉 代	王 代
玴	玉 世	王 世
玵	玉 甘	王 甘
玶	玉 平	王 平
玷	玉 占	王 占
玸	玉 包	王 包
玹	玉 玄	王 玄
玻	玉 皮	王 皮
玼	玉 此	王 此
玽	玉 句	王 句
玾	玉 甲	王 甲
玿	玉 召	王 召
珀	玉 白	王 白
珁	玉 瓦	王 瓦
珂	玉 可	王 可
珃	玉 冉	王 冉
珄	玉 生	王 生
珅	玉 申	王 申
珆	玉 台	王 台
珇	玉 且	王 且
珈	玉 加	王 加
珉	玉 民	王 民
珊	玉 冊	王 冊
珋	玉 卯	王 卯
珌	玉 必	王 必
珍	玉 人 彡	王 人 彡
珎	玉 尓	王 尓
珏	玉 玉	王 玉
珒	玉 聿	王 聿
珓	玉 交	王 交
珔	玉 存	王 存
珕	玉 劦	王 劦
珖	玉 光	王 光
珗	玉 先	王 先
珘	玉 舟	王 舟
珙	玉 共	王 共
珚	玉 因	王 因
珛	玉 有	王 有
珜	玉 羊	王 羊
珝	玉 羽	王 羽
珞	玉 各	王 各
珟	玉 夙	王 夙
珠	玉 朱	王 朱
珡	玉 玉 人	王 王 人
珢	玉 艮	王 艮
珣	玉 旬	王 旬
珤	玉 缶	王 缶
珥	玉 耳	王 耳
珦	玉 向	王 向
珧	玉 兆	王 兆
珨	玉 合	王 合
珩	玉 行	王 行
珪	玉 圭	王 圭
珫	玉 充	王 充
珬	玉 戌	王 戌
班	王 刂 王	玉 刂 王
珮	玉 几 帀
珳	玉 彣	王 彣
珴	玉 我	王 我
珵	玉 呈	王 呈
珶	玉 弟	王 弟
珷	玉 武	王 武
珸	玉 吾	王 吾
珹	玉 成	王 成
珺	玉 君	王 君
珻	玉 每	王 每
珼	玉 貝	王 貝
珽	玉 廷	王 廷
現	玉 見	王 見
珿	玉 足	王 足
琀	玉 含	王 含
琁	玉 丿 一 疋	王 丿 一 疋
琂	玉 言	王 言
球	玉 求	王 求
琄	玉 肙	王 肙
理	玉 里	王 里
琇	玉 秀	王 秀
琈	玉 孚	王 孚
琉	玉 亠 厶 川	王 亠 厶 川	王 巟	玉 㐬	王 㐬
琊	玉 邪	王 邪
琋	玉 希	王 希
琌	玉 岑	王 岑
琍	玉 利	王 利
琓	玉 完	王 完
琔	玉 定	王 定
琕	玉 卑	王 卑
琖	玉 戔	王 戔
琗	玉 卒	王 卒
琘	玉 昏	王 昏
琙	玉 或	王 或
琚	玉 居	王 居
琛	玉 罙	王 罙
琜	玉 來	王 來
琝	玉 旻	王 旻
琞	明 玉
琟	玉 隹	王 隹
琠	玉 典	王 典
琡	玉 叔	王 叔
琢	玉 豖	王 豖
琣	玉 咅	王 咅
琤	玉 爭	王 爭
琥	玉 虎	王 虎
琦	玉 奇	王 奇
琧	亞 玉
琨	玉 昆	王 昆
琩	玉 昌	王 昌
琪	玉 其	王 其
琫	玉 奉	王 奉
琬	玉 宛	王 宛
琭	玉 彔	王 彔
琮	玉 宗	王 宗
琯	玉 官	王 官
琰	玉 炎	王 炎
琱	玉 周	王 周
琲	玉 非	王 非
琳	玉 林	王 林
琴	玉 玉 今	王 王 今
琵	玉 比	王 比
琶	玉 巴	王 巴
琷	玉 羌	王 羌
琸	玉 卓	王 卓
琹	玉 玉 木	王 王 木
琺	玉 法	王 法
琽	玉 者	王 者
琾	玉 界	王 界
琿	玉 軍	王 軍
瑀	玉 禹	王 禹
瑁	玉 冒	王 冒
瑂	玉 眉	王 眉
瑄	玉 宣	王 宣
瑅	玉 是	王 是
瑆	玉 星	王 星
瑇	玉 毒	王 毒
瑈	玉 柔	王 柔
瑉	玉 昬	王 昬
瑊	玉 咸	王 咸
瑋	玉 韋	王 韋
瑌	玉 耎	王 耎
瑍	玉 奐	王 奐
瑎	玉 皆	王 皆
瑏	玉 穿	王 穿
瑐	玉 前	王 前
瑑	玉 彖	王 彖
瑒	玉 昜	王 昜
瑓	玉 柬	王 柬
瑔	玉 泉	王 泉
瑕	玉 叚
瑖	玉 段	王 段
瑗	玉 爰	王 爰
瑘	玉 耶	王 耶
瑙	玉 巛 囟	王 巛 囟	玉 𡿺	王 𡿺
瑚	玉 胡	王 胡
瑛	玉 英	王 英
瑜	玉 俞	王 俞
瑝	玉 皇	王 皇
瑞	玉 耑	王 耑
瑟	玉 必	王 必
瑠	玉 留	王 留
瑢	玉 容	王 容
瑣	玉 小 貝	王 小 貝
瑤	玉 䍃	王 月 缶	玉 䍃	王 䍃
瑥	玉 昷	王 昷
瑦	玉 烏	王 烏
瑧	玉 秦	王 秦
瑨	玉 晉	王 晉
瑩	火 火 冖 玉	𤇾 玉
瑪	玉 馬	王 馬
瑫	玉 舀	王 舀
瑬	流 玉
瑭	玉 唐	王 唐
瑮	玉 栗	王 栗
瑯	玉 郎	王 郎
瑰	玉 鬼	王 鬼
瑱	玉 真	王 真
瑲	玉 倉	王 倉
瑳	玉 差	王 差
瑴	士 冖 一 王 殳
瑵	玉 蚤	王 蚤
瑹	玉 荼	王 荼
瑺	玉 常	王 常
瑻	玉 貫	王 貫
瑼	玉 專	王 專
瑽	玉 從	王 從
瑾	玉 堇	王 堇
瑿	殹 玉
璀	玉 崔	王 崔
璁	玉 悤	王 悤
璂	玉 基	王 基
璃	玉 离	王 离
璄	玉 竟	王 竟
璅	玉 巢	王 巢
璆	玉 翏	王 翏
璇	玉 旋	王 旋
璈	玉 敖	王 敖
璉	玉 連	王 連
璊	玉 廿 冂 丨 入 入	王 廿 冂 丨 入 入	玉 㒼	王 㒼
璋	玉 章	王 章
璌	玉 寅	王 寅
璏	玉 彘	王 彘
璐	玉 路	王 路
璑	玉 無	王 無
璒	玉 登	王 登
璔	玉 曾	王 曾
璕	玉 尋	王 尋
璖	玉 渠	王 渠
璗	湯 玉
璘	玉 粦	王 粦
璙	玉 尞	王 尞
璚	玉 矞	王 矞
璛	玉 肅	王 肅
璜	玉 黃	王 黃
璝	玉 貴	王 貴
璞	玉 菐	王 菐
璟	玉 景	王 景
璠	玉 番	王 番
璡	玉 進	王 進
璢	玉 畱	王 畱
璣	玉 幾	王 幾
璥	玉 敬	王 敬
璦	玉 愛	王 愛
璧	辟 玉
璨	玉 粲	王 粲
璩	玉 豦	王 豦
璪	玉 喿	王 喿
璫	玉 當	王 當
璬	玉 敫	王 敫
璭	玉 運	王 運
璮	玉 亶	王 亶
璯	玉 會	王 會
環	玉 睘	王 睘
璱	玉 瑟	王 瑟
璲	玉 遂	王 遂
璳	玉 朱 貝	王 朱 貝
璵	玉 與	王 與
璶	玉 盡	王 盡
璷	玉 敷	王 敷
璸	玉 賓	王 賓
璹	玉 壽	王 壽
璺	臼 同 冖 玉
璻	玉 翠	王 翠
璼	玉 監	王 監
璽	爾 玉
璾	玉 齊	王 齊
璿	玉 睿	王 睿
瓀	玉 需	王 需
瓁	玉 蒦	王 蒦
瓂	玉 蓋	王 蓋
瓃	玉 畾	王 畾
瓄	玉 賣	王 賣
瓅	玉 樂	王 樂
瓆	玉 質	王 質
瓇	玉 憂	王 憂
瓈	玉 黎	王 黎
瓉	玉 賛	王 賛
瓊	玉 夐	王 夐
瓋	玉 適	王 適
瓌	玉 褱	王 褱
瓍	玉 隨	王 隨
瓎	玉 賴	王 賴
瓏	玉 龍	王 龍
瓐	玉 盧	王 盧
瓑	玉 歷	王 歷
瓓	玉 闌	王 闌
瓔	玉 嬰	王 嬰
瓕	彌 玉
瓖	玉 襄	王 襄
瓗	玉 巂	王 巂
瓘	玉 雚	王 雚
瓙	玉 壽	王 壽
瓚	玉 贊	王 贊
瓛	玉 獻	王 獻
瓜	爪 一 丶
瓝	瓜 勺
瓞	瓜 失
瓟	瓜 包
瓠	夸 瓜
瓡	幸 瓜
瓢	票 瓜
瓣	辛 瓜 辛
瓤	襄 瓜
瓥	瓜 豕 蟲 蟲	瓜 豕 虫 虫
瓨	工 瓦
瓪	瓦 反
瓫	分 瓦
瓬	方 瓦
瓭	冘 瓦
瓮	公 瓦
瓳	古 瓦
瓴	令 瓦
瓵	台 瓦
瓶	并 瓦	幷 瓦
瓷	次 瓦
瓹	肙 瓦
瓺	镸 瓦
瓻	希 瓦
瓽	尚 瓦
瓾	委 瓦
瓿	咅 瓦
甀	垂 瓦
甁	幷 瓦
甂	扁 瓦
甃	秋 瓦
甄	垔 瓦
甆	茲 瓦
甇	火 火 冖 瓦	𤇾 瓦
甈	臬 瓦
甉	兼 瓦
甊	婁 瓦
甋	啇 瓦
甌	區 瓦
甍	草 网 冖 瓦	艸 网 冖 瓦	艹 罒 冖 瓦
甎	專 瓦
甏	彭 瓦
甐	粦 瓦
甑	曽 瓦	曾 瓦
甒	無 瓦
甓	辟 瓦
甔	詹 瓦
甕	雍 瓦
甖	賏 瓦	貝 貝 瓦
甗	虎 鬲 瓦	虍 鬲 瓦
甘	廿 一
甙	甘 弋
甚	甘 匹	其 乚
甛	甘 舌
甜	舌 甘
甝	虎 甘
甞	尚 甘
生	牛 一	丿 三 丨
甠	日 生
甡	生 生
產	产 生	文 厂 生
産	产 生	立 丿 生
甤	豕 生
甥	生 男
甦	更 生
甧	生 生 月
用	月 丨	冂 十 一
甩	月 乚
甪	丶 用
甫	一 丶 用
甬	龴 用
甭	不 用
甮	勿 用
甯	宀 心 用
田	囗 十
由	囗 十
甲	囗 十
申	囗 十
甴	口 丄
甶	丶 田
男	田 力
甸	勹 田
甹	由 亏	由 丂
町	田 丁
甼	田 丁
甽	田 川
甾	巛 田
甿	田 亡
畀	田 丌
畁	由 丌
畂	田 久
畃	申 勺
畄	小 田
畆	亩 厶
畇	田 勻
畈	田 反
畉	田 夫
畊	田 井
畋	田 攴	田 攵
界	田 介
畍	田 介
畎	田 犬
畏	田 一 □
畐	一 口 田
畑	火 田
畒	亩 人
畔	田 半
畕	田 田
畖	田 瓜
畗	亠 口 田	丶 畐 田
畘	田 冉
留	卯 田
畚	厶 大 田
畛	田 人 彡
畜	玄 田
畝	亩 久
畞	十 田 久
畟	田 八 夂
畡	田 亥
畢	田 艹 一 十
畣	人 畐
畤	田 寺
略	田 各
畦	田 圭	田 土 土
畧	田 各
畨	米 田
番	釆 田	采 田
畫	聿 田 一
畬	余 田
畭	田 余
畮	田 母
畯	田 夋
異	田 共
畱	丣 田
畲	余 田
畳	田 冝
畵	聿 田 凵
當	尚 田
畷	田 叕
畸	田 奇
畹	田 宛
畺	一 田 一 田 一	三 田 田
畻	田 丷 夫 土	田 𠔉 土
畼	田 昜
畽	田 重
畾	田 田 田
畿	幺 幺 戈 田	幾 田
疀	甾 疌
疁	田 翏
疃	田 童
疄	田 粦
疅	田 畺
疆	弓 土 畺
疇	田 壽
疈	畐 丶 丿 畐
疉	畾 宀 彑
疊	畾 冝
疋	乛 卜 人
疌	一 聿 卜 人	一 肀 卜 人
疍	疋 旦
疎	疋 束
疏	疋 亠 厶 川	疋 巟	疋 㐬
疐	十 冖 田 疋
疑	匕 矢 龴 疋
疒	丶 厂 冫	丶 一 丬
疓	病 乃	疒 乃
疔	病 丁	疒 丁
疕	病 匕	疒 匕
疘	病 工	疒 工
疙	病 乞	疒 乞
疚	病 久	疒 久
疛	病 寸	疒 寸
疜	病 下	疒 下
疝	病 山	疒 山
疞	病 亏	疒 亏
疢	病 火	疒 火
疣	病 尤	疒 尤
疤	病 巴	疒 巴
疥	病 介	疒 介
疦	病 夬	疒 夬
疧	病 氏	疒 氏
疨	病 牙	疒 牙
疩	病 卆	疒 卆
疪	病 必	疒 必
疫	病 殳	疒 殳
疰	病 主	疒 主
疱	病 包	疒 包
疲	病 皮	疒 皮
疳	病 甘	疒 甘
疴	病 可	疒 可
疵	病 此	疒 此
疶	病 世	疒 世
疷	病 氐	疒 氐
疸	病 旦	疒 旦
疹	病 人 彡	疒 人 彡
疺	病 乏	疒 乏
疻	病 只	疒 只
疼	病 冬	疒 冬
疽	病 且	疒 且
疾	病 矢	疒 矢
疿	病 弗	疒 弗
痀	病 句	疒 句
痁	病 占	疒 占
痂	病 加	疒 加
痃	病 玄	疒 玄
痄	病 乍	疒 乍
病	病 丙	疒 丙
痆	病 尼	疒 尼
症	病 正	疒 正
痊	病 全	疒 全
痋	病 蟲	疒 蟲	疒 虫
痌	病 同	疒 同
痍	病 夷	疒 夷
痎	病 亥	疒 亥
痏	病 有	疒 有
痐	病 回	疒 回
痑	病 多	疒 多
痓	病 至	疒 至
痔	病 寺	疒 寺
痕	病 艮	疒 艮
痗	病 每	疒 每
痘	病 豆	疒 豆
痙	病 巠	疒 巠
痚	病 孝	疒 孝
痛	病 甬	疒 甬
痜	病 禿	疒 禿
痝	病 尨	疒 尨
痞	病 否	疒 否
痟	病 肖	疒 肖
痠	病 夋	疒 夋
痡	病 甫	疒 甫
痢	病 利	疒 利
痣	病 志	疒 志
痤	病 坐	疒 坐
痥	病 兌	疒 兌
痦	病 吾	疒 吾
痧	病 沙	疒 沙
痩	病 申 又	疒 申 又
痬	病 易	疒 易
痭	病 朋	疒 朋
痮	病 長	疒 長
痯	病 官	疒 官
痰	病 炎	疒 炎
痱	病 非	疒 非
痲	病 林	疒 林
痳	病 林	疒 林
痵	病 季	疒 季
痶	病 典	疒 典
痷	病 奄	疒 奄
痸	病 制	疒 制
痹	病 畀	疒 畀
痺	病 卑	疒 卑
痻	病 昏	疒 昏
痼	病 固	疒 固
痽	病 隹	疒 隹
痾	病 阿	疒 阿
痿	病 委	疒 委
瘀	病 於	疒 於
瘁	病 卒	疒 卒
瘂	病 亞	疒 亞
瘃	病 豖	疒 豖
瘄	病 昔	疒 昔
瘇	病 重	疒 重
瘈	病 契	疒 契
瘉	病 俞	疒 俞
瘊	病 侯	疒 侯
瘋	病 風	疒 風
瘌	病 剌	疒 剌
瘍	病 昜	疒 昜
瘎	病 甚	疒 甚
瘏	病 者	疒 者
瘐	病 臾	疒 臾
瘑	病 咼	疒 咼
瘒	病 軍	疒 軍
瘓	病 奐	疒 奐
瘔	病 苦	疒 苦
瘕	病 叚	疒 叚
瘖	病 音	疒 音
瘙	病 蚤	疒 蚤
瘚	病 欮	疒 欮
瘛	病 恝	疒 恝
瘜	病 息	疒 息
瘝	病 眔	疒 眔
瘞	病 座	疒 座
瘟	病 昷	疒 昷
瘠	病 脊	疒 脊
瘡	病 倉	疒 倉
瘢	病 般	疒 般
瘣	病 鬼	疒 鬼
瘤	病 留	疒 留
瘥	病 差	疒 差
瘦	病 叟	疒 叟
瘧	病 虐	疒 虐
瘨	病 真	疒 真
瘩	病 荅	疒 荅
瘬	病 張	疒 張
瘭	病 票	疒 票
瘮	病 參	疒 參
瘯	病 族	疒 族
瘰	病 累	疒 累
瘱	病 夾	疒 夾
瘲	病 從	疒 從
瘳	病 翏	疒 翏
瘴	病 章	疒 章
瘵	病 祭	疒 祭
瘶	病 欶	疒 欶
瘷	病 敕	疒 敕
瘸	病 加 肉	疒 加 肉
瘹	病 釣	疒 釣
瘺	病 屚	疒 屚
瘻	病 婁	疒 婁
瘼	病 莫	疒 莫
瘽	病 堇	疒 堇
癀	病 黃	疒 黃
癁	病 復	疒 復
療	病 尞	疒 尞
癃	病 隆	疒 隆
癄	病 焦	疒 焦
癅	病 畱	疒 畱
癆	病 勞	疒 勞
癇	病 閒	疒 閒
癈	病 發	疒 發
癉	病 單	疒 單
癊	病 陰	疒 陰
癋	病 惡	疒 惡
癌	病 品 山	疒 品 山	疒 喦
癍	病 斑	疒 斑
癎	病 間	疒 間
癏	病 睘	疒 睘
癐	病 會	疒 會
癑	病 農	疒 農
癒	病 愈	疒 愈
癓	病 微	疒 微
癔	病 意	疒 意
癕	病 雍	疒 雍
癖	病 辟	疒 辟
癗	病 雷	疒 雷
癘	病 萬	疒 萬
癙	病 鼠	疒 鼠
癚	病 詹	疒 詹
癛	病 稟	疒 稟
癜	病 殿	疒 殿
癟	病 自 侖	疒 自 侖
癠	病 齊	疒 齊
癡	病 疑	疒 疑
癢	病 養	疒 養
癤	病 節	疒 節
癥	病 徵	疒 徵
癧	病 歷	疒 歷
癨	病 霍	疒 霍
癩	病 賴	疒 賴
癬	病 鮮	疒 鮮
癭	病 嬰	疒 嬰
癮	病 隱	疒 隱
癯	病 瞿	疒 瞿
癰	病 雝	疒 雝
癱	病 難	疒 難
癲	病 顛	疒 顛
癳	病 纍	疒 纍
癴	病 攣	疒 攣
癵	病 臠	疒 臠
癸	癶 天
癹	癶 殳
発	癶 兀 一	癶 二 儿	癶 开
登	癶 豆
發	癶 弓 殳
白	丿 日	丶 日
百	一 白
癿	白 乙	白 乚
皀	白 匕
皁	白 十
皂	白 七
皃	白 儿
的	白 勺
皅	白 巴
皆	比 白
皇	白 王
皈	白 反
皉	白 此
皊	白 令
皋	白 夲	白 大 十	白 本
皌	白 末
皍	白 匕 卩
皎	白 交
皏	白 并	白 幷
皐	白 二 十 二
皒	白 我
皓	白 告
皔	白 旱
皕	百 百
皖	白 完
皗	白 周
皘	白 青
皙	析 白
皚	白 豈
皛	白 白 白
皜	白 高
皝	皇 光
皞	白 皋
皟	白 責
皠	白 崔
皡	白 皐
皢	白 堯
皣	白 華
皤	白 番
皥	白 臯
皦	白 敫
皧	白 愛
皨	皛 土
皩	皇 晃
皪	白 樂
皫	白 麃
皬	白 霍
皭	白 爵
皮	乛 丿 丨 又	丿 支
皯	皮 干
皰	皮 包
皳	求 皮
皴	夋 皮
皵	昔 皮
皶	查 皮
皷	十 豆 皮
皸	軍 皮
皹	皮 軍
皺	芻 皮
皻	虘 皮
皼	壹 皮
皽	亶 皮
皾	賣 皮
皿	冊 一
盀	卜 皿
盁	乃 皿
盂	于 皿
盃	不 皿
盄	弔 皿
盅	中 皿
盆	分 皿
盇	太 皿
盈	乃 又 皿	夃 皿
盉	禾 皿
益	丷 一 八 皿
盋	犮 皿
盌	夗 皿
盍	去 皿
盎	央 皿
盒	合 皿
盓	汙 皿
盔	灰 皿
盕	汎 皿
盙	甫 皿
盚	求 皿
盛	成 皿
盜	水 欠 皿	氵 欠 皿
盝	彔 皿
盞	戔 皿
盟	明 皿
盠	彖 皿
盡	聿 火 皿	聿 灬 皿
盢	畎 皿
監	臣 丿 一 丶 皿
盤	般 皿
盥	臼 水 皿
盦	今 酉 皿
盧	虎 田 皿	虍 田 皿
盨	須 皿
盩	幸 攵 皿
盪	湯 皿
盫	合 酉 皿
盬	臣 丿 一 古 皿
盭	幺 幸 攴 皿	幺 幸 攵 皿
目	囗 二
盯	目 丁
盰	目 干
盱	目 于
盲	目 亡
盳	目 亡
直	十 目 丨 一
盵	目 乞
盶	目 元
盷	目 勺
相	木 目
盹	目 屯
盺	目 斤
盻	目 兮
盼	目 分
盽	目 丰
盾	厂 十 目
盿	目 文
眀	目 月
省	少 目
眂	目 氏
眃	目 云
眄	目 丏
眅	目 反
眆	目 方
眇	目 少
眈	目 冘
眉	尸 丶 目
眊	目 毛
看	手 目
県	目 丨 一 小
眎	目 示
眏	目 央
眐	目 正
眑	目 幼
眒	目 申
眓	目 戉
眔	目 丨 八 八
眕	目 人 彡
眖	目 兄
眗	目 句
眘	大 丷 目
眙	目 台
眚	生 目
眛	目 未
眜	目 末
眝	目 宁
眞	匕 目 丨 一 八
真	十 目 一 八	直 八
眠	目 民
眡	目 氐
眢	夗 目
眣	目 失
眤	目 尼
眥	此 目
眦	目 此
眧	目 召
眨	目 乏
眩	目 玄
眪	目 丙
眫	目 半
眭	目 圭
眮	目 同
眰	目 至
眱	目 夷
眲	目 耳
眳	目 名
眴	目 旬
眵	目 多
眶	目 匡
眷	丷 夫 目	𠔉 目
眸	目 牟
眹	目 关
眺	目 兆
眻	目 羊
眼	目 艮
眽	目 厂 氏	目 𠂢
眾	网 丿 丨 人 人	罒 丿 丨 人 人	罓 丿 丨 人 人
眿	目 永
睂	仌 丨 厂 目
睃	目 夋
睄	目 肖
睅	目 旱
睆	目 完
睇	目 弟
睈	目 呈
睉	目 坐
睊	目 肙
睋	目 我
睌	目 免
睍	目 見
睎	目 希
睏	目 困
睒	目 炎
睓	目 典
睔	目 侖
睕	目 宛
睖	目 夌
睗	目 易
睘	罒 一 口 
睙	目 戾
睚	目 厓
睛	目 青
睜	目 爭
睞	目 來
睟	目 卒
睠	目 卷
睡	目 垂
睢	目 隹
督	叔 目
睤	目 畀
睥	目 卑
睦	目 坴	目 土 儿 土
睧	目 昏
睨	目 兒
睩	目 彔
睪	罒 幸
睫	目 疌
睬	目 采
睭	目 周
睮	目 俞
睯	敃 目
睰	目 若
睱	目 叚
睲	目 星
睳	目 奎
睴	目 軍
睶	目 春
睷	目 建
睸	目 眉
睹	目 者
睺	目 侯
睻	目 宣
睼	目 是
睽	目 癸
睾	丶 目 幸	丶 罒 幸
睿	卜 冖 一 八 人 目
瞀	敄 目
瞁	目 狊
瞂	盾 犮
瞃	目 盾
瞄	目 苗
瞅	目 秋
瞇	目 迷
瞈	目 翁
瞉	士 冖 一 目 殳
瞊	目 唐
瞋	目 真
瞌	目 盍	目 去 皿
瞍	目 叟
瞎	目 害
瞏	目 袁	罒 袁
瞐	目 目 目
瞑	目 冥
瞓	目 訓
瞔	目 責
瞕	目 章
瞖	殹 目
瞗	目 鳥
瞘	目 區
瞙	目 莫
瞚	目 寅
瞛	目 從
瞜	目 婁
瞝	目 离
瞞	目 廿 冂 丨 入 入	目 㒼
瞟	目 票
瞠	目 堂
瞡	目 規
瞢	草 网 冖 目	艸 网 冖 目	艹 罒 冖 目
瞤	目 閏
瞥	敝 目
瞦	目 喜
瞧	目 焦
瞨	目 菐
瞪	目 登
瞫	目 覃
瞬	目 舜
瞭	目 尞
瞮	目 育 攴	目 育 攵
瞯	目 閒
瞰	目 敢
瞱	目 華
瞲	目 矞
瞳	目 童
瞴	目 無
瞵	目 粦
瞶	目 貴
瞷	目 間
瞸	目 葉
瞹	目 愛
瞺	目 會
瞻	目 詹
瞼	目 僉
瞽	鼓 目
瞾	目 目 空
瞿	目 目 隹
矀	目 微
矁	目 愁
矂	目 喿
矃	目 寧
矄	目 熏
矅	目 翟
矆	目 蒦
矇	目 蒙
矈	目 臱
矉	目 賓
矊	目 綿
矋	目 厲
矌	目 廣
矍	瞿 又	目 目 隻	目 目 隹 又
矎	目 夐
矏	目 臱
矐	目 霍
矑	目 盧
矒	目 瞢
矓	目 龍
矔	目 雚
矕	絲 言 目	糸 言 糸 目	䜌 目
矖	目 麗
矗	直 直 直
矘	目 黨
矙	目 闞
矚	目 屬
矛	予 丿
矜	矛 今
矝	矛 令
矞	矛 冏
矟	矛 肖
矠	矛 昔
矡	矛 矍
矢	丿 天
矣	厶 矢
矤	弓 矢
知	矢 口
矦	厃 矢
矧	矢 引
矨	矢 夭
矩	矢 巨
矪	矢 舟
矬	矢 坐
短	矢 豆
矮	矢 委
矯	矢 喬
矰	矢 曾
矱	矢 蒦
矲	矢 罷
石	一 丿 口
矴	石 丁
矵	石 刀	石 刂
矷	石 子
矸	石 干
矹	石 兀
矺	石 乇
矻	石 乞
矼	石 工
矽	石 夕
矾	石 凡
砂	石 少
砃	石 丹
砄	石 夬
砅	石 水
砆	石 夫
砇	石 文
砈	石 厄
砉	丰 石
砊	石 亢
砋	石 止
砌	石 切
砍	石 欠
砎	石 介
砏	石 分
砐	石 及
砑	石 牙
砒	石 比
砓	石 殳
研	石 开
砕	石 卆
砘	石 屯
砙	石 瓦
砝	石 去
砞	石 末
砟	石 乍
砠	石 且
砡	石 玉
砢	石 可
砣	石 它
砤	石 丿 一 也
砥	石 氐
砦	此 石
砧	石 占
砨	石 戹
砩	石 弗
砪	石 母
砫	石 主
砬	石 立
砭	石 乏
砮	奴 石
砯	石 氷
砰	石 平
砱	石 令
砲	石 包
砳	石 石
破	石 皮
砵	石 本
砶	石 白
砷	石 申
砸	石 匝
砹	石 艾
砼	石 仝
硂	石 全
硃	石 朱
硄	石 光
硅	石 圭
硆	石 合
硇	石 囟
硈	石 吉
硉	石 聿
硊	石 危
硋	石 亥
硌	石 各
硍	石 艮
硎	石 刑
硏	石 幵
硐	石 同
硑	石 并	石 幷
硒	石 西
硔	石 共
硜	石 巠
硝	石 肖
硞	石 告
硟	石 延
硠	石 良
硡	石 宏
硢	石 余
硣	石 孝
硤	石 夾
硥	石 尨
硦	石 弄
硧	石 甬
硨	石 車
硩	折 石
硪	石 我
硫	石 亠 厶 川	石 巟	石 㐬
硬	石 更
硭	石 芒
硯	石 見
硰	沙 石
硱	石 困
硲	石 谷
硶	石 岑
硸	石 岸
硹	石 松
硺	石 豖
硻	臤 石
硼	石 朋
硽	石 奄
硾	石 垂
硿	石 空
碀	石 爭
碁	其 石
碂	石 宗
碃	石 青
碄	石 林
碅	石 囷
碆	波 石
碇	石 定
碈	石 昏
碉	石 周
碊	石 戔
碋	石 岢
碌	石 彔
碎	石 卒
碏	石 昔
碐	石 夌
碑	石 卑
碒	石 金
碓	石 隹
碔	石 武
碕	石 奇
碖	石 侖
碗	石 宛
碘	石 典
碙	石 岡
碚	石 咅
碝	石 耎
碞	品 石
碟	石 枼	石 世 木
碠	石 亭
碡	石 毒
碢	石 咼
碣	石 曷
碤	石 英
碥	石 扁
碦	石 客
碧	王 白 石
碨	石 畏
碩	石 頁
碪	石 甚
碫	石 段
碬	石 叚
碭	石 昜
碮	石 是
碯	石 巛 囟	石 𡿺
碰	石 並
碱	石 咸
碲	石 帝
碳	石 炭
碴	石 查
碶	石 契
碸	石 風
碹	石 宣
確	石 隺
碻	石 高
碼	石 馬
碽	石 貢
碾	石 展
碿	石 屑
磀	石 逆
磁	石 茲	石 兹
磂	石 留
磃	石 虒
磄	石 唐
磅	石 旁
磆	石 骨
磇	石 囟 比
磈	石 鬼
磉	石 桑
磊	石 石 石
磋	石 差
磌	石 真
磍	石 害
磎	石 奚
磏	石 兼
磐	般 石
磑	石 豈
磒	石 員
磓	石 追
磔	石 桀
磕	石 盍	石 去 皿
磖	石 習
磘	石 爪 缶	石 爫 缶
磙	石 衮
磚	石 專
磛	斬 石
磜	石 祭
磝	石 敖
磞	石 崩
磟	石 翏
磠	石 鹵
磡	石 勘	石 甚 力
磢	石 爽
磣	石 參
磤	石 殷
磥	石 累
磦	石 票
磧	石 責
磨	麻 石
磩	石 戚
磪	石 崔
磫	石 從
磬	声 殳 石	殸 石
磭	石 脣
磯	石 幾
磰	石 善
磱	石 勞
磲	石 渠
磳	石 曾
磴	石 登
磵	石 間
磶	石 舄
磷	石 粦
磸	石 奠
磹	石 覃
磺	石 黃
磻	石 番
磼	石 集
磽	石 堯
磾	石 單
磿	厤 石
礁	石 焦
礃	石 掌
礄	石 喬
礅	石 敦
礆	石 僉
礇	石 奧
礈	石 遂
礉	石 敫
礊	車 凵 殳 石
礋	石 睪
礌	石 雷
礍	石 葛
礎	石 楚
礏	石 業
礐	臼 爻 冖 石	𦥯 石
礑	石 當
礒	石 義
礓	石 畺
礔	石 辟
礕	辟 石
礖	石 與
礗	石 賓
礘	石 日 幺 幺 火	石 日 幺 幺 灬	石 㬎
礙	石 疑
礚	石 蓋
礛	石 監
礜	與 石
礝	石 需
礞	石 蒙
礟	石 駁
礠	石 慈
礡	石 蒪
礣	石 蔑
礤	石 蔡
礥	石 賢
礦	石 廣
礧	石 畾
礨	畾 石
礩	石 質
礪	石 厲
礫	石 樂
礬	棥 大 石	木 爻 木 大 石
礭	石 霍
礮	石 馬 交
礯	石 縈
礰	石 歷
礱	龍 石
礲	石 龍
礳	石 磨
礴	石 薄
礵	石 霜
礶	石 雚
礷	石 藍
礸	石 贊
礹	石 嚴
示	二 小
礻	丶 乙 丨 丶
礽	示 乃	礻 乃
社	示 土	礻 土
礿	示 勺	礻 勺
祀	示 巳	礻 巳
祁	示 邑	礻 阝
祂	示 也	礻 也
祄	示 介	礻 介
祅	示 夭	礻 夭
祆	示 天	礻 天
祇	示 氏	礻 氏
祈	示 斤	礻 斤
祉	示 止	礻 止
祊	示 方	礻 方
祋	示 殳	礻 殳
祌	示 中	礻 中
祏	示 石	礻 石
祐	示 右	礻 右
祑	示 失	礻 失
祒	示 召	礻 召
祓	示 犮	礻 犮
祔	示 付	礻 付
祕	示 必	礻 必
祖	示 且	礻 且
祗	示 氐	礻 氐
祘	示 示
祙	示 未	礻 未
祚	示 乍	礻 乍
祛	示 去	礻 去
祜	示 古	礻 古
祝	示 兄	礻 兄
神	示 申	礻 申
祟	出 示
祠	示 司	礻 司
祡	此 示
祣	示 丿 一 氏	礻 丿 一 氏
祤	示 羽	礻 羽
祥	示 羊	礻 羊
祦	示 吴	礻 吴
祧	示 兆	礻 兆
票	西 示	襾 示	覀 示
祩	示 朱	礻 朱
祪	示 危	礻 危
祫	示 合	礻 合
祬	示 至	礻 至
祭	夗 示
祮	示 吉	礻 吉
祰	示 告	礻 告
祱	示 兌	礻 兌
祲	示 彐 冖 又	礻 彐 冖 又
祳	示 辰	礻 辰
祴	示 戒	礻 戒
祵	示 困	礻 困
祶	示 弟	礻 弟
祹	示 匋	礻 匋
祺	示 其	礻 其
祻	示 固	礻 固
祼	示 果	礻 果
祽	示 卒	礻 卒
祾	示 夌	礻 夌
祿	示 彔	礻 彔
禁	林 示
禂	示 周	礻 周
禃	示 直	礻 直
禆	示 卑	礻 卑
禇	示 者	礻 者
禈	示 軍	礻 軍
禉	示 酋	礻 酋
禊	示 契	礻 契
禋	示 垔	礻 垔
禌	示 兹	礻 兹
禍	示 咼	礻 咼
禎	示 貞	礻 貞
福	示 畐	礻 畐
禐	示 爰	礻 爰
禑	示 禺	礻 禺
禒	示 彖	礻 彖
禓	示 昜	礻 昜
禔	示 是	礻 是
禕	示 韋	礻 韋
禖	示 某	礻 某
禗	示 思	礻 思
禘	示 帝	礻 帝
禚	示 羔	礻 羔
禛	示 眞	礻 眞
禜	火 火 冖 示	𤇾 示
禝	示 畟	礻 畟
禞	示 高	礻 高
禟	示 唐	礻 唐
禠	示 虒	礻 虒
禡	示 馬	礻 馬
禢	示 日 羽	礻 日 羽
禤	示 目 羽	礻 罒 羽
禥	示 基	礻 基
禦	御 示
禧	示 喜	礻 喜
禨	示 幾	礻 幾
禩	示 異	礻 異
禪	示 單	礻 單
禫	示 覃	礻 覃
禬	示 會	礻 會
禭	示 遂	礻 遂
禮	示 豊	礻 豊
禯	示 農	礻 農
禰	示 爾	礻 爾
禱	示 壽	礻 壽
禲	示 厲	礻 厲
禳	示 襄	礻 襄
禴	示 龠	礻 龠
禵	示 題	礻 題
禶	示 贊	礻 贊
禷	示 類	礻 類
禸	冂 厶
禹	丿 口 冂 厶
禺	甲 禸	日 禸
禼	卜 口 乂 冂 厶
禽	人 离
禾	丿 木
禿	禾 儿
秀	禾 乃
私	禾 厶
秂	禾 人
秄	禾 子
秅	禾 乇
秆	禾 干
秇	禾 丸
秈	禾 山
秉	禾 聿	禾 肀	丿 一 彐 丨 丿 乀
秊	禾 千
秋	禾 火
秌	火 禾
秎	禾 分
秏	禾 毛
秐	禾 云
科	禾 斗
秒	禾 少
秓	禾 支
秔	禾 亢
秕	禾 比
秖	禾 氏
秗	禾 夭
秘	禾 必
秙	禾 古
秚	禾 半
秛	禾 皮
秜	禾 尼
秝	禾 禾
秞	禾 由
租	禾 且
秠	禾 丕
秡	禾 犮
秢	禾 令
秣	禾 末
秤	禾 平
秥	禾 占
秦	手 乀 禾	龹 禾
秧	禾 央
秨	禾 乍
秩	禾 失
秪	禾 氐
秫	禾 朮
秬	禾 巨
秭	禾 丿 ㇉ 丨 丿	禾 𠂔
秮	禾 台
秱	禾 同
秲	禾 寺
秳	禾 舌
秴	禾 合
秵	禾 因
秶	次 禾
秷	禾 至
秸	禾 吉
秹	禾 任
秺	禾 宅
移	禾 多
秼	禾 朱
秿	禾 甫
稀	禾 希
稁	亠 口 冂 禾
稂	禾 良
稃	禾 孚
稄	禾 夋
稅	禾 兌
稆	禾 呂
稇	禾 困
稈	禾 旱
稉	禾 更
稊	禾 弟
程	禾 呈
稌	禾 余
稍	禾 肖
稏	禾 亞
稐	禾 侖
稑	禾 坴
稒	禾 固
稓	禾 昔
稔	禾 念
稕	禾 享
稖	禾 咅
稗	禾 卑
稘	禾 其
稙	禾 直
稚	禾 隹
稛	禾 困
稜	禾 夌
稝	禾 朋
稞	禾 果
稟	亠 回 禾
稠	禾 周
稡	禾 卒
稢	禾 或
稤	禾 京
稦	禾 韋
稧	禾 契
稨	禾 扁
稩	禾 胃
稪	禾 复
稫	禾 畐
稬	禾 耎
稭	禾 皆
種	禾 重
稯	禾 凶 八 夕	禾 凶 八 夂
稰	禾 胥
稱	禾 爯	禾 爪 冉	禾 爫 冉
稲	禾 爪 旧	禾 爫 旧
稴	禾 兼
稵	禾 兹
稶	禾 彧
稷	禾 田 儿 夕	禾 田 儿 夂	禾 畟
稸	禾 畜
稹	禾 真
稺	禾 屖
稻	禾 舀
稼	禾 家
稽	禾 尤 旨
稾	高 禾
稿	禾 高
穀	士 冖 禾 殳
穁	禾 茸
穂	禾 恵
穄	禾 祭
穅	禾 康
穆	禾 白 小 彡
穇	禾 參
穈	麻 禾
穉	禾 犀
穊	禾 既
穋	禾 翏
穌	魚 禾
積	禾 責
穎	匕 禾 頁
穏	禾 爪 彐 心	禾 爫 彐 心
穐	禾 亀
穓	禾 異
穔	禾 黃
穕	禾 集
穖	禾 幾
穗	禾 惠
穘	禾 堯
穙	禾 菐
穚	禾 喬
穛	禾 焦
穜	禾 童
穟	禾 遂
穠	禾 農
穡	禾 嗇
穢	禾 歲
穣	禾 衣 八 井 一
穤	禾 需
穥	禾 與
穧	禾 齊
穨	禿 貴
穩	禾 爪 工 彐 心	禾 爫 工 彐 心	禾 㥯
穪	禾 爾
穫	禾 蒦	禾 草 隹 又
穬	禾 廣
穭	禾 魯
穮	禾 麃
穰	禾 襄
穱	禾 爵
穲	禾 麗
穳	禾 贊
穴	宀 八
穵	穴 乙
究	穴 九
穸	穴 夕
穹	穴 弓
空	穴 工
穻	穴 于
穼	穴 木
穽	穴 井
穾	穴 夭
穿	穴 牙
窀	穴 屯
突	穴 犬
窂	穴 牛
窄	穴 乍
窅	穴 目
窆	穴 乏
窇	穴 包
窈	穴 幼
窉	穴 丙
窊	穴 瓜
窋	穴 出
窌	穴 卯
窏	穴 汙
窐	穴 圭
窒	穴 至
窓	穴 厶 心
窔	穴 交
窕	穴 兆
窖	穴 告
窗	穴 囱
窘	穴 君
窙	穴 孝
窚	穴 成
窛	穴 元 女
窞	穴 臽
窟	穴 屈
窠	穴 果
窡	穴 叕
窢	穴 或
窣	穴 卒
窨	穴 音
窩	穴 咼
窪	穴 洼	穴 水 圭	穴 氵 圭
窫	穴 契
窬	穴 俞
窮	穴 躬
窯	穴 羔
窰	穴 月 缶	穴 䍃
窱	穴 條
窲	穴 料
窳	穴 瓜 瓜
窴	穴 真
窵	穴 鳥
窶	穴 婁
窷	穴 聊
窸	穴 悉
窹	穴 爿 吾
窺	穴 規
窻	穴 悤	窗 心
窼	穴 巢
窾	穴 款
窿	穴 隆
竀	穴 正 見
竁	穴 毳
竂	穴 尞
竄	穴 鼠
竅	穴 敫
竆	穴 躳
竇	穴 賣
竈	穴 土 黽
竉	穴 龍
竊	穴 釆 禼	穴 采 禼
立	亠 丷 一
竌	立 几
竎	立 廾
竐	立 殳
竑	立 厷
竒	立 口 亅	亠 丷 可
竗	立 少
竘	立 句
站	立 占
竚	立 宁
竛	立 令
竜	立 电
竝	立 立
竟	立 日 儿
章	立 早
竢	立 矣
竣	立 夋
竤	立 宏
童	立 里
竦	立 束
竧	立 身
竨	立 卓
竩	立 宜
竪	臣 又 立
竫	立 爭
竬	立 禹
竭	立 曷
竮	立 屏
端	立 耑	立 山 而
竰	立 厘
竱	立 專
竲	立 曾
竳	立 登
竴	立 尊
竵	立 鬲 匸 丨	立 一 口 匸 丨 冂 丷 丅
競	竞 竞	立 兄 立 兄
竸	竟 竟	竝 覞
竹	丿 一 丨 丿 一 亅
竺	竹 二
竻	竹 力
竼	竹 凡
竽	竹 于
竾	竹 也
竿	竹 干
笀	竹 亡
笁	竹 工
笄	竹 开
笅	竹 爻
笆	竹 巴
笇	竹 卞
笈	竹 及
笉	竹 勻
笊	竹 爪
笌	竹 牙
笍	竹 內
笎	竹 元
笏	竹 勿
笐	竹 亢
笑	竹 夭
笒	竹 今
笓	竹 比
笖	竹 以
笗	竹 冬
笘	竹 占
笙	竹 生
笚	竹 甲
笛	竹 由
笜	竹 出
笝	竹 囗 又
笞	竹 台
笟	竹 瓜
笠	竹 立
笡	竹 且
笢	竹 民
笣	竹 包
笤	竹 召
笥	竹 司
符	竹 付
笧	竹 册
笨	竹 本
笩	竹 代
笪	竹 旦
笫	竹 丿 ㇉ 丨 丿	竹 𠂔
第	竹 弔 丿	竹 弓 丨 丿
笭	竹 令
笮	竹 乍
笯	竹 奴
笰	竹 弗
笱	竹 句
笲	竹 弁
笳	竹 加
笴	竹 可
笵	竹 氾
笶	竹 矢
笷	竹 卯
笸	竹 叵
笻	竹 卭
笿	竹 各
筀	竹 圭
筁	竹 曲
筂	竹 池
筃	竹 因
筄	竹 兆
筅	竹 先
筆	竹 聿
筇	竹 邛
筈	竹 舌
等	竹 寺
筊	竹 交
筋	竹 肉 力	竹 月 力
筌	竹 全
筍	竹 旬
筎	竹 如
筏	竹 伐
筐	竹 匡
筒	竹 同
筓	竹 幵
答	竹 合
筕	竹 行
策	竹 朿
筗	竹 仲
筘	竹 扣
筙	竹 耒
筞	竹 宋
筟	竹 孚
筠	竹 均
筡	竹 余
筢	竹 把
筣	竹 利
筤	竹 良
筥	竹 呂
筦	竹 完
筧	竹 見
筨	竹 含
筩	竹 甬
筪	竹 匣
筫	竹 貝
筬	竹 成
筭	竹 弄
筮	竹 巫
筯	竹 助
筰	竹 作
筱	竹 攸
筲	竹 肖
筳	竹 廷
筴	竹 夾
筵	竹 延
筶	竹 告
筷	竹 快
筸	竹 旱
筻	竹 更
箁	竹 咅
箂	竹 來
箃	竹 取
箄	竹 卑
箅	竹 畀
箆	竹 內 比
箇	竹 固
箈	竹 治
箉	竹 拐
箊	竹 於
箋	竹 戔
箌	竹 到
箍	竹 手 匝	竹 扌 匝	竹 才 匝
箎	竹 虎
箏	竹 爭
箐	竹 青
箑	竹 疌
箒	竹 帚
箔	竹 泊
箕	竹 其
箖	竹 林
算	竹 目 廾
箘	竹 囷
箙	竹 服
箚	竹 合 刀	竹 合 刂
箛	竹 孤
箜	竹 空
箝	竹 拑
箞	竹 卷
箟	竹 昆
箠	竹 垂
管	竹 官
箢	竹 宛
箣	竹 刺
箤	竹 卒
箥	竹 波
箬	竹 若
箭	竹 前
箯	竹 便
箰	筍 子
箱	竹 相
箲	竹 洗
箳	竹 屏
箴	竹 咸
箵	竹 省
箶	竹 胡
箷	竹 施
箸	竹 者
箹	竹 約
箺	竹 春
箻	竹 律
箼	竹 屋
箽	竹 重
箾	竹 削
箿	竹 咠
節	竹 艮 卩
篁	竹 皇
篂	竹 星
篃	竹 眉
範	竹 車 卩	竹 車 㔾
篅	竹 耑
篆	竹 彖
篇	竹 扁
篈	竹 封
築	筑 木	竹 巩 木	竹 工 凡 木
篊	竹 洪
篋	竹 匧
篌	竹 侯
篍	竹 秋
篎	竹 眇
篏	竹 甘 欠
篔	竹 員
篕	竹 盍
篖	竹 唐
篗	竹 隻
篘	竹 芻
篙	竹 高
篚	竹 匪
篛	竹 弱
篜	竹 烝
篝	竹 冓
篞	竹 涅	竹 水 日 工	竹 氵 日 工
篟	竹 倩
篠	竹 條
篡	竹 目 大 厶
篢	竹 貢
篣	竹 旁
篤	竹 馬
篥	竹 栗
篦	竹 囟 比
篧	竹 隺
篨	竹 除
篩	竹 師
篪	竹 虒
篫	筑 手	竹 巩 手
篬	竹 倉
篭	竹 竜
篰	竹 部
篲	竹 彗
篳	竹 畢
篴	竹 逐
篵	竹 從
篶	竹 焉
篷	竹 逢
篸	竹 參
篹	竹 目 大 卩	竹 目 大 㔾
篺	竹 捭
篻	竹 票
篼	竹 兜
篽	竹 御
篾	竹 网 戍	竹 罒 戍	竹 罓 戍
篿	竹 專
簀	竹 責
簁	竹 徙
簂	竹 國
簃	竹 移
簄	竹 扈
簅	竹 產
簆	竹 寇
簇	竹 族
簈	竹 幷
簉	竹 造
簊	竹 基
簋	竹 艮 皿
簌	竹 欶	竹 束 欠
簍	竹 婁
簎	竹 措
簏	竹 鹿
簐	竹 軟
簑	竹 衰
簒	竹 目 大 么
簔	竹 衰
簕	竹 勒
簘	竹 粛
簙	竹 博
簚	竹 网 戈 巾	竹 罒 戈 巾
簛	竹 斯
簜	竹 湯
簝	竹 尞
簞	竹 單
簟	竹 覃
簠	竹 盙
簡	竹 間
簢	竹 閔
簣	竹 貴
簤	竹 買
簥	竹 喬
簦	竹 登
簧	竹 黃
簨	竹 巽
簩	竹 勞
簪	竹 旡 旡 日	竹 朁
簫	竹 肅
簬	竹 路
簭	竹 筮 人 口
簮	竹 夫 夫 日
簰	竹 牌
簲	竹 脾
簳	竹 幹
簴	竹 虡
簵	竹 輅
簶	竹 祿
簷	竹 詹
簸	竹 其 皮
簹	竹 當
簺	竹 塞
簻	竹 過
簼	竹 搆
簽	竹 僉
簾	竹 廉
簿	竹 薄
籀	竹 手 留	竹 扌 留
籃	竹 監
籄	竹 貴
籅	竹 與
籆	竹 蒦
籇	竹 豪
籈	竹 甄
籉	竹 臺
籊	竹 翟
籋	竹 爾
籌	竹 壽
籍	竹 耤
籐	竹 滕
籑	竹 目 一 食	竹 目 大 良
籒	竹 手 畱	竹 扌 畱	竹 才 畱
籓	竹 潘
籔	竹 數
籕	竹 榴
籗	竹 霍
籘	竹 縢
籙	竹 錄
籚	竹 盧
籛	竹 戔
籜	竹 擇
籝	竹 嬴
籞	竹 禦
籟	竹 賴
籠	竹 龍
籢	竹 斂
籣	竹 闌
籤	竹 韱	竹 人 人 戈 韭
籥	竹 龠
籦	竹 鍾
籧	竹 豦
籨	竹 歛
籩	竹 邊
籪	竹 斷
籫	竹 贊
籬	竹 離
籭	竹 麗
籮	竹 羅
籯	竹 贏
籰	竹 矍
籱	竹 雨 雔	竹 雨 隹 隹
籲	籥 頁	竹 龠 頁
米	丷 木
籵	米 十
籶	米 几
籷	米 乇
籸	米 卂
籹	米 女
籺	米 乞
籼	米 山
籽	米 子
籾	米 刃
籿	米 寸
粁	米 千
粃	米 比
粄	米 反
粅	米 勿
粆	米 少
粇	米 亢
粈	米 丑
粉	米 分
粊	比 米
粋	米 卆
粍	米 毛
粎	米 尺
粑	米 巴
粒	米 立
粓	米 甘
粔	米 巨
粕	米 白
粖	米 末
粗	米 且
粘	米 占
粙	米 由
粚	米 丿 一 也
粛	聿 丿 米 丨	肀 丿 米 丨
粜	出 米
粞	米 西
粟	西 米	襾 米	覀 米
粠	米 共
粡	米 同
粢	次 米
粣	米 冊
粥	弓 米 弓
粦	米 舛
粨	米 百
粯	米 見
粰	米 孚
粱	水 刀 八 米	氵 刀 八 米
粲	歹 又 米	歺 又 米
粳	米 更
粴	米 里
粵	丶 冂 采 亏	丶 冂 釆 亏
粶	米 录
粷	米 匊
粸	米 其
粹	米 卒
粺	米 卑
粻	米 長
粼	粦 巜
粽	米 宗
精	米 青
粿	米 果
糂	米 甚
糃	米 昜
糄	米 扁
糅	米 柔
糆	米 面
糇	米 侯
糈	米 胥
糉	米 凶 八 夕	米 凶 八 夂
糊	米 胡
糋	米 前
糌	米 夂 人 日
糍	米 茲
糎	米 厘
糏	米 屑
糐	米 尃
糑	米 弱
糒	米 草 厂 用	米 艹 厂 用
糓	士 冖 一 米 殳
糔	米 蚤
糕	米 羔
糖	米 唐
糗	米 臭
糙	米 造
糚	米 莊
糛	米 堂
糜	麻 米
糝	米 參
糞	米 異	米 田 共
糟	米 曹
糠	米 康
糡	米 竟
糢	米 莫
糣	米 旡 旡 日	米 朁
糤	米 散
糥	米 需
糦	米 喜
糧	米 量
糨	米 強
糩	米 會
糪	辟 米
糫	米 睘
糮	米 堅
糯	米 需
糰	米 團
糱	辥 米
糲	米 厲
糳	丵 臼 殳 米
糴	籴 翟
糵	薛 米
糶	粜 翟
糷	米 蘭
糸	幺 小
糺	絲 乚	糹 乚	糸 乚
系	丿 糸	丿 幺 小
糼	絲 力	糹 力	糸 力
糽	絲 丁	糹 丁	糸 丁
糾	絲 丩	糹 丩	糸 丩
糿	絲 刀	糹 刀	糸 刀
紀	絲 己	糹 己	糸 己
紁	絲 义	糹 义	糸 义
紂	絲 寸	糹 寸	糸 寸
紃	絲 川	糹 川	糸 川
約	絲 勺	糹 勺	糸 勺
紅	絲 工	糹 工	糸 工
紆	絲 于	糹 于	糸 于
紇	絲 乞	糹 乞	糸 乞
紈	絲 丸	糹 丸	糸 丸
紉	絲 刃	糹 刃	糸 刃
紊	文 絲	文 糸
紋	絲 文	糹 文	糸 文
紌	絲 尤	糹 尤	糸 尤
納	絲 內	糹 內	糸 內
紎	絲 犬	糹 犬	糸 犬
紏	絲 斗	糹 斗	糸 斗
紐	絲 丑	糹 丑	糸 丑
紑	絲 不	糹 不	糸 不
紒	絲 介	糹 介	糸 介
紓	絲 予	糹 予	糸 予
純	絲 屯	糹 屯	糸 屯
紕	絲 比	糹 比	糸 比
紖	絲 引	糹 引	糸 引
紗	絲 少	糹 少	糸 少
紘	絲 厷	糹 厷	糸 厷
紙	絲 氏	糹 氏	糸 氏
級	絲 及	糹 及	糸 及
紛	絲 分	糹 分	糸 分
紜	絲 云	糹 云	糸 云
紝	絲 壬	糹 壬	糸 壬
紞	絲 冘	糹 冘	糸 冘
紟	絲 今	糹 今	糸 今
素	丰 絲	丰 糸
紡	絲 方	糹 方	糸 方
索	十 冖 絲	十 冖 糸
紣	絲 卆	糹 卆	糸 卆
紤	絲 斤	糹 斤	糸 斤
紥	扎 糸
紨	絲 付	糹 付	糸 付
紩	絲 失	糹 失	糸 失
紪	絲 此	糹 此	糸 此
紫	此 絲	此 糸
紬	絲 由	糹 由	糸 由
紭	絲 弘	糹 弘	糸 弘
紮	札 絲	札 糸
累	田 絲	田 糸
細	絲 田	糹 田	糸 田
紱	絲 犮	糹 犮	糸 犮
紲	絲 世	糹 世	糸 世
紳	絲 申	糹 申	糸 申
紴	絲 皮	糹 皮	糸 皮
紵	絲 宁	糹 宁	糸 宁
紶	絲 去	糹 去	糸 去
紷	絲 令	糹 令	糸 令
紸	絲 主	糹 主	糸 主
紹	絲 召	糹 召	糸 召
紺	絲 甘	糹 甘	糸 甘
紻	絲 央	糹 央	糸 央
紼	絲 弗	糹 弗	糸 弗
紽	絲 它	糹 它	糸 它
紾	絲 人 彡	糹 人 彡	糸 人 彡
紿	絲 台	糹 台	糸 台
絀	絲 出	糹 出	糸 出
絁	絲 丿 一 也	糹 丿 一 也	糸 丿 一 也
終	絲 冬	糹 冬	糸 冬
絃	絲 玄	糹 玄	糸 玄
組	絲 且	糹 且	糸 且
絅	絲 冋	糹 冋	糸 冋
絆	絲 半	糹 半	糸 半
絇	絲 句	糹 句	糸 句
絈	絲 白	糹 白	糸 白
絉	絲 术	糹 术	糸 术
絊	絲 本	糹 本	糸 本
経	絲 圣	糹 圣	糸 圣
絍	絲 任	糹 任	糸 任
絎	絲 行	糹 行	糸 行
絏	絲 曳	糹 曳	糸 曳
結	絲 吉	糹 吉	糸 吉
絑	絲 朱	糹 朱	糸 朱
絒	絲 州	糹 州	糸 州
絓	絲 圭	糹 圭	糸 圭
絔	絲 百	糹 百	糸 百
絕	絲 刀 巴	糹 刀 巴	糸 刀 巴	絲 色	糹 色	糸 色
絖	絲 光	糹 光	糸 光
絗	絲 回	糹 回	糸 回
絘	絲 次	糹 次	糸 次
絙	絲 亘	糹 亘	糸 亘
絚	絲 亙	糹 亙	糸 亙
絛	攸 糸
絜	丰 刀 糸
絝	絲 夸	糹 夸	糸 夸
絞	絲 交	糹 交	糸 交
絟	絲 全	糹 全	糸 全
絠	絲 有	糹 有	糸 有
絡	絲 各	糹 各	糸 各
絢	絲 旬	糹 旬	糸 旬
絣	絲 并	糹 并	糸 并	絲 幷	糹 幷	糸 幷
絤	絲 西	糹 西	糸 西
絥	絲 伏	糹 伏	糸 伏
給	絲 合	糹 合	糸 合
絧	絲 同	糹 同	糸 同
絨	絲 戎	糹 戎	糸 戎
絩	絲 兆	糹 兆	糸 兆
絪	絲 因	糹 因	糸 因
絫	厽 糸
絬	絲 舌	糹 舌	糸 舌
絭	丷 夫 糸	𠔉 糸
絮	如 絲	如 糸
絯	絲 亥	糹 亥	糸 亥
絰	絲 至	糹 至	糸 至
統	絲 充	糹 充	糸 充
絲	絲 絲	糹 糹	糸 糸
絳	絲 夅	糹 夅	糸 夅
絴	絲 羊	糹 羊	糸 羊
絵	絲 会	糹 会	糸 会
絶	絲 色	糹 色	糸 色
絸	絲 見	糹 見	糸 見
絹	絲 肙	糹 肙	糸 肙
絺	絲 希	糹 希	糸 希
絻	絲 免	糹 免	糸 免
絼	絲 豸	糹 豸	糸 豸
絽	絲 呂	糹 呂	糸 呂
絾	絲 成	糹 成	糸 成
絿	絲 求	糹 求	糸 求
綀	絲 束	糹 束	糸 束
綁	絲 邦	糹 邦	糸 邦
綂	絲 亠 兄	糹 亠 兄	糸 亠 兄
綃	絲 肖	糹 肖	糸 肖
綄	絲 完	糹 完	糸 完
綅	絲 彐 冖 又	糹 彐 冖 又	糸 彐 冖 又
綆	絲 更	糹 更	糸 更
綇	絲 酉	糹 酉	糸 酉
綈	絲 弟	糹 弟	糸 弟
綉	絲 秀	糹 秀	糸 秀
綊	絲 夾	糹 夾	糸 夾
綋	絲 宏	糹 宏	糸 宏
綌	絲 谷	糹 谷	糸 谷
綍	絲 孛	糹 孛	糸 孛
綎	絲 廷	糹 廷	糸 廷
綏	絲 妥	糹 妥	糸 妥
綐	絲 兌	糹 兌	糸 兌
綑	絲 困	糹 困	糸 困
綒	絲 孚	糹 孚	糸 孚
經	絲 巠	糹 巠	糸 巠
綔	夸 系
綕	絲 志	糹 志	糸 志
綖	絲 延	糹 延	糸 延
綗	絲 冏	糹 冏	糸 冏
綘	絲 夆	糹 夆	糸 夆
綜	絲 宗	糹 宗	糸 宗
綝	絲 林	糹 林	糸 林
綞	絲 垂	糹 垂	糸 垂
綟	絲 戻	糹 戻	糸 戻
綠	絲 彔	糹 彔	糸 彔
綡	絲 京	糹 京	糸 京
綢	絲 周	糹 周	糸 周
綣	絲 卷	糹 卷	糸 卷
綤	邵 糸
綥	絲 畀	糹 畀	糸 畀
綦	其 糸
綧	絲 享	糹 享	糸 享
綨	絲 其	糹 其	糸 其
綩	絲 宛	糹 宛	糸 宛
綪	絲 青	糹 青	糸 青
綫	絲 戔	糹 戔	糸 戔
綬	絲 受	糹 受	糸 受
維	絲 隹	糹 隹	糸 隹
綮	戶 攵 糸	户 攵 糸
綯	絲 匋	糹 匋	糸 匋
綰	絲 官	糹 官	糸 官
綱	絲 岡	糹 岡	糸 岡
網	絲 罔	糹 罔	糸 罔
綳	絲 朋	糹 朋	糸 朋
綴	絲 叕	糹 叕	糸 叕
綵	絲 采	糹 采	糸 采
綶	絲 果	糹 果	糸 果
綷	絲 卒	糹 卒	糸 卒
綸	絲 侖	糹 侖	糸 侖
綹	絲 咎	糹 咎	糸 咎
綺	絲 奇	糹 奇	糸 奇
綻	絲 定	糹 定	糸 定
綼	絲 卑	糹 卑	糸 卑
綽	絲 卓	糹 卓	糸 卓
綾	絲 夌	糹 夌	糸 夌
綿	絲 帛	糹 帛	糸 帛
緀	絲 妻	糹 妻	糸 妻
緁	絲 疌	糹 疌	糸 疌
緂	絲 炎	糹 炎	糸 炎
緃	絲 從	糹 從	糸 從
緄	絲 昆	糹 昆	糸 昆
緅	絲 取	糹 取	糸 取
緆	絲 易	糹 易	糸 易
緇	絲 甾	糹 甾	糸 甾
緈	絲 幸	糹 幸	糸 幸
緉	絲 兩	糹 兩	糸 兩
緊	臤 絲	臤 糸
緋	絲 非	糹 非	糸 非
緌	絲 委	糹 委	糸 委
緍	絲 昏	糹 昏	糸 昏
緎	絲 或	糹 或	糸 或
総	絲 忩	糹 忩	糸 忩
緐	每 系
緑	絲 录	糹 录	糸 录
緒	絲 者	糹 者	糸 者
緓	絲 英	糹 英	糸 英
緔	絲 尚	糹 尚	糸 尚
緖	絲 者 丶	糹 者 丶	糸 者 丶
緗	絲 相	糹 相	糸 相
緘	絲 咸	糹 咸	糸 咸
緙	絲 革	糹 革	糸 革
線	絲 泉	糹 泉	糸 泉
線	絲 泉	糹 泉	糸 泉
緛	絲 耎	糹 耎	糸 耎
緜	帛 系
緝	絲 咠	糹 咠	糸 咠
緞	絲 段	糹 段	糸 段
緟	絲 重	糹 重	糸 重
締	絲 帝	糹 帝	糸 帝
緡	絲 昬	糹 昬	糸 昬
緢	絲 苗	糹 苗	糸 苗
緣	絲 彖	糹 彖	糸 彖
緤	絲 枼	糹 枼	糸 枼
緥	絲 保	糹 保	糸 保
緦	絲 思	糹 思	糸 思
緧	絲 酋	糹 酋	糸 酋
編	絲 扁	糹 扁	糸 扁
緩	絲 爰	糹 爰	糸 爰
緪	絲 恆	糹 恆	糸 恆
緫	絲 怱	糹 怱	糸 怱
緬	絲 面	糹 面	糸 面
緭	絲 胃	糹 胃	糸 胃
緮	絲 复	糹 复	糸 复
緯	絲 韋	糹 韋	糸 韋
緰	絲 俞	糹 俞	糸 俞
緱	絲 侯	糹 侯	糸 侯
緲	絲 目 少	糹 目 少	糸 目 少
緳	广 絜
練	絲 柬	糹 柬	糸 柬
緵	絲 凶 八 夕	糹 凶 八 夕	糸 凶 八 夕	絲 凶 八 夂	糹 凶 八 夂	糸 凶 八 夂
緶	絲 便	糹 便	糸 便
緷	絲 軍	糹 軍	糸 軍
緸	絲 垔	糹 垔	糸 垔
緹	絲 是	糹 是	糸 是
緺	絲 咼	糹 咼	糸 咼
緻	絲 致	糹 致	糸 致
緼	絲 昷	糹 昷	糸 昷
緽	絲 貞	糹 貞	糸 貞
緾	絲 厘	糹 厘	糸 厘
緿	絲 怠	糹 怠	糸 怠
縀	絲 叚	糹 叚	糸 叚
縁	絲 緣	糹 緣	糸 緣
縂	絲 总	糹 总	糸 总
縃	絲 胥	糹 胥	糸 胥
縆	絲 恒	糹 恒	糸 恒
縈	火 火 冖 絲	火 火 冖 糸	𤇾 絲	𤇾 糸
縉	絲 晉	糹 晉	糸 晉
縊	絲 益	糹 益	糸 益
縋	絲 追	糹 追	糸 追
縌	絲 逆	糹 逆	糸 逆
縍	絲 旁	糹 旁	糸 旁
縎	絲 骨	糹 骨	糸 骨
縏	般 糸
縐	絲 芻	糹 芻	糸 芻
縑	絲 兼	糹 兼	糸 兼
縒	絲 差	糹 差	糸 差
縓	絲 原	糹 原	糸 原
縔	絲 桑	糹 桑	糸 桑
縕	絲 昷	糹 昷	糸 昷
縖	絲 害	糹 害	糸 害
縗	絲 衰	糹 衰	糸 衰
縘	絲 奚	糹 奚	糸 奚
縙	絲 茸	糹 茸	糸 茸
縚	絲 舀	糹 舀	糸 舀
縛	絲 尃	糹 尃	糸 尃
縜	絲 員	糹 員	糸 員
縝	絲 真	糹 真	糸 真
縞	絲 高	糹 高	糸 高
縟	絲 辱	糹 辱	糸 辱
縠	士 冖 系 殳
縡	絲 宰	糹 宰	糸 宰
縢	肉 絭	月 絭
縣	県 系
縤	絲 素	糹 素	糸 素
縥	絲 秦	糹 秦	糸 秦
縦	絲 従	糹 従	糸 従
縧	絲 條	糹 條	糸 條
縩	絲 祭	糹 祭	糸 祭
縪	絲 畢	糹 畢	糸 畢
縫	絲 逢	糹 逢	糸 逢
縬	絲 戚	糹 戚	糸 戚
縭	絲 离	糹 离	糸 离
縮	絲 宿	糹 宿	糸 宿
縯	絲 寅	糹 寅	糸 寅
縰	絲 徙	糹 徙	糸 徙
縱	絲 從	糹 從	糸 從
縲	絲 累	糹 累	糸 累
縳	絲 專	糹 專	糸 專
縴	絲 牽	糹 牽	糸 牽
縵	絲 曼	糹 曼	糸 曼
縶	執 糸
縷	絲 婁	糹 婁	糸 婁
縸	絲 莫	糹 莫	糸 莫
縹	絲 票	糹 票	糸 票
縺	絲 連	糹 連	糸 連
縻	麻 糸
縼	絲 旋	糹 旋	糸 旋
總	絲 悤	糹 悤	糸 悤	糸 囱 心
績	絲 責	糹 責	糸 責
縿	絲 參	糹 參	糸 參
繀	絲 崔	糹 崔	糸 崔
繁	每 攴 絲	每 攵 糸
繂	絲 率	糹 率	糸 率
繃	絲 崩	糹 崩	糸 崩
繄	殹 糸
繅	絲 巢	糹 巢	糸 巢
繆	絲 翏	糹 翏	糸 翏
繇	月 缶 系	䍃 系
繈	絲 強	糹 強	糸 強
繉	絲 目 兆	糹 目 兆	糸 目 兆
繋	軗 糸
繍	絲 粛	糹 粛	糸 粛
繎	絲 然	糹 然	糸 然
繏	絲 巽	糹 巽	糸 巽
繐	絲 惠	糹 惠	糸 惠
繑	絲 喬	糹 喬	糸 喬
繒	絲 曾	糹 曾	糸 曾
繓	絲 最	糹 最	糸 最
織	絲 戠	糹 戠	糸 戠
繕	絲 善	糹 善	糸 善
繖	絲 散	糹 散	糸 散
繗	絲 粦	糹 粦	糸 粦
繘	絲 矞	糹 矞	糸 矞
繙	絲 番	糹 番	糸 番
繚	絲 尞	糹 尞	糸 尞
繛	素 卓
繜	絲 尊	糹 尊	糸 尊
繝	絲 閒	糹 閒	糸 閒
繞	絲 堯	糹 堯	糸 堯
繟	絲 單	糹 單	糸 單
繠	惢 糸
繡	絲 肅	糹 肅	糸 肅
繢	絲 貴	糹 貴	糸 貴
繣	絲 畫	糹 畫	糸 畫
繤	苜 大 糸
繥	絲 喜	糹 喜	糸 喜
繦	絲 强	糹 强	糸 强
繨	絲 達	糹 達	糸 達
繩	絲 黽	糹 黽	糸 黽
繪	絲 會	糹 會	糸 會
繫	車 凵 殳
繬	絲 嗇	糹 嗇	糸 嗇
繭	草 冂 丨 絲 蟲	草 冂 丨 糸 虫	艹 虫 茧	艸 冂 丨 糸 虫	艹 冂 丨 糸 虫
繮	絲 畺	糹 畺	糸 畺
繯	絲 睘	糹 睘	糸 睘
繰	絲 喿	糹 喿	糸 喿
繱	絲 葱	糹 葱	糸 葱
繲	絲 解	糹 解	糸 解
繳	絲 敫	糹 敫	糸 敫
繴	辟 糸
繵	絲 亶	糹 亶	糸 亶
繶	絲 意	糹 意	糸 意
繷	絲 農	糹 農	糸 農
繸	絲 遂	糹 遂	糸 遂
繹	絲 睪	糹 睪	糸 睪
繺	絲 煞	糹 煞	糸 煞
繻	絲 需	糹 需	糸 需
繼	絲 丨 一 幺 幺 一 幺 幺	糹 丨 一 幺 幺 一 幺 幺	糸 丨 一 幺 幺 一 幺 幺	糸 𠃊 幺 幺 一 幺 幺
繽	絲 賓	糹 賓	糸 賓
繾	絲 遣	糹 遣	糸 遣
繿	絲 監	糹 監	糸 監
纀	絲 僕	糹 僕	糸 僕
纁	絲 熏	糹 熏	糸 熏
纂	竹 目 大 絲	竹 目 大 糸	竹 目 大 丝
纃	絲 齊	糹 齊	糸 齊
纄	絲 蓬	糹 蓬	糸 蓬
纅	絲 樂	糹 樂	糸 樂
纆	絲 墨	糹 墨	糸 墨
纇	米 糸 頁
纈	絲 頡	糹 頡	糸 頡
纉	絲 賛	糹 賛	糸 賛
纊	絲 廣	糹 廣	糸 廣
纋	絲 憂	糹 憂	糸 憂
續	絲 賣	糹 賣	糸 賣
纍	畾 糸
纎	絲 韯	糹 韯	糸 韯
纏	絲 广 里 儿 土	糹 广 里 儿 土	糸 广 里 儿 土
纑	絲 盧	糹 盧	糸 盧
纒	絲 广 黒 土	糹 广 黒 土	糸 广 黒 土
纓	絲 嬰	糹 嬰	糸 嬰
纔	絲 毚	糹 毚	糸 毚
纕	絲 襄	糹 襄	糸 襄
纖	絲 韱	糹 韱	糸 韱
纗	絲 巂	糹 巂	糸 巂
纘	絲 贊	糹 贊	糸 贊
纙	絲 羅	糹 羅	糸 羅
纚	絲 麗	糹 麗	糸 麗
纛	毒 縣
纜	絲 覽	糹 覽	糸 覽
纝	絲 纍	糹 纍	糸 纍
纞	絲 戀	糹 戀	糸 戀
缶	丿 二 山
缷	缶 卩
缸	缶 工
缹	缶 火	缶 灬
缺	缶 夬
缻	缶 瓦
缽	缶 本
缾	缶 并	缶 幷
缿	缶 后
罁	缶 岡
罃	火 火 冖 缶	𤇾 缶
罄	声 殳 缶	殸 缶
罅	缶 虖
罆	缶 貫
罇	缶 尊
罈	缶 覃
罉	缶 掌
罊	車 凵 殳 缶
罋	雍 缶
罌	貝 貝 缶
罍	畾 缶
罎	缶 曇
罏	缶 盧
罐	缶 雚
罒	冖 丨 丨 一
罓	冖 乂
罔	冂 丷 一 亡
罕	网 干	罓 干	冖 八 干	㓁 干
罘	网 不	罒 不
罙	网 木	罒 木	㓁 木
罛	网 瓜	罒 瓜
罜	网 主	罒 主
罝	网 且	罒 且
罞	网 矛	罒 矛
罟	网 古	罒 古
罠	网 民	罒 民
罡	网 正	罒 正
罣	网 圭	罒 圭
罤	网 弟	罒 弟
罥	网 肙	罒 肙
罦	网 孚	罒 孚
罧	网 林	罒 林	罓 林
罨	网 奄	罒 奄
罩	网 卓	罒 卓	罓 卓
罪	网 非	罒 非	罓 非
罫	网 卦	罒 卦
罬	网 叕	罒 叕
罭	网 或	罒 或
置	网 直	罒 直	罓 直
罯	网 音	罒 音
罰	网 言 刀	罒 訁 刂	罓 訁 刂
罱	网 南	罒 南
署	网 者	罒 者
罳	网 思	罒 思
罵	网 馬	罒 馬	罓 馬	口 口 馬
罶	网 留	罒 留
罷	网 能	罒 能
罸	网 討	罒 討
罹	网 心 隹	罒 忄 隹	罓 忄 隹
罺	网 巢	罒 巢
罻	网 尉	罒 尉
罼	网 畢	罒 畢
罽	网 厂 剡	罒 厂 剡
罾	网 曾	罒 曾
罿	网 童	罒 童
羀	网 畱	罒 畱
羂	网 絹	罒 絹
羃	网 幕	罒 幕
羄	网 綽	罒 綽
羅	网 維	罒 維	罓 維
羆	网 熊	罒 熊	罷 火	罷 灬
羇	网 革 奇	罒 革 奇
羈	网 革 馬	罒 革 馬
羉	目 絲 言	目 糸 言 糸	目 䜌	罒 䜌
羊	丷 三 丨
羋	卝 丨 干
羌	羊 儿
羍	大 羊
美	羊 大
羏	羊 彡
羐	艹 土 久
羑	羊 久
羒	羊 分
羓	羊 巴
羔	羊 火	羊 灬
羕	羊 永
羖	羊 殳
羗	羌 厶
羘	肉 羊	月 羊
羙	羊 火
羚	羊 令
羛	羊 弗
羜	羊 宁
羝	羊 氐
羞	羊 丿 丑
羠	羊 夷
羢	羊 戎
羣	君 羊
群	君 羊
羥	羊 巠
羦	羊 完
羧	羊 夋
羨	羊 水 欠	羊 氵 欠
義	羊 我
羫	羊 空
羬	羊 咸
羭	羊 俞
羮	羔 一 夫
羯	羊 曷
羰	羊 炭
羱	羊 原
羲	羊 禾 丂 戈
羳	羊 番
羴	羊 羊 羊
羵	羊 賁
羶	羊 亶
羷	羊 僉
羸	亡 口 月 羊 凡
羹	羔 美
羺	羊 需
羻	羊 慶
羼	尸 羴
羽	习 习
羾	羽 工
羿	羽 廾
翀	羽 中
翁	公 羽
翂	羽 分
翃	厷 羽
翄	羽 支
翅	支 羽
翆	羽 卆
翇	羽 犮
翈	甲 羽
翉	本 羽
翊	立 羽
翋	羽 立
翌	羽 立
翍	羽 皮
翎	令 羽
翏	羽 人 彡
翐	羽 失
翑	羽 句
習	羽 白
翓	吉 羽
翔	羊 羽
翕	合 羽
翖	合 羽
翗	多 羽
翛	攸 羽
翜	羽 夾
翝	宏 羽
翞	羽 京
翟	羽 隹
翠	羽 卒
翡	非 羽
翢	周 羽
翣	羽 妾
翤	口 冊
翥	者 羽
翦	前 羽
翧	宣 羽
翨	羽 是
翩	扁 羽
翪	羽 凶 八 夕	羽 凶 八 夂
翫	習 元
翬	羽 軍
翭	羽 侯
翮	鬲 羽
翯	羽 高
翰	十 日 十 人 羽
翲	票 羽
翳	殹 羽
翴	羽 連
翵	羽 鳥
翷	粦 羽
翸	賁 羽
翹	堯 羽
翺	臯 羽
翻	番 羽
翼	羽 異
翽	歲 羽
翾	睘 羽
翿	壽 羽
耀	光 翟
老	土 丿 匕	耂 匕	老 匕
耂	土 丿
考	土 丿 丂	耂 丂	老 丂
耄	老 毛
者	土 丿 日	耂 日	老 日
耆	老 日
耇	老 句	耂 句
耈	老 句
耉	考 口
耊	老 至	耂 至
耋	老 至
而	一 丶 冂 丨 丨
耍	而 女
耎	而 大
耏	而 彡
耐	而 寸
耑	山 而
耒	二 木	一 未	末 一
耓	耒 丁
耔	耒 子
耕	耒 井
耖	耒 少
耗	耒 毛
耘	耒 云
耙	耒 巴
耚	耒 皮
耛	耒 台
耜	耒 尸 乛 一
耝	耒 且
耞	耒 加
耟	耒 巨
耠	耒 合
耡	耒 助
耣	耒 侖
耤	耒 昔
耥	耒 尚
耦	耒 禺
耨	耒 辱
耩	耒 冓
耪	耒 旁
耫	耒 責
耬	耒 婁
耭	耒 幾
耮	耒 勞
耯	耒 蒦
耰	耒 憂
耱	耒 磨
耲	耒 褱
耴	耳 乚
耵	耳 丁
耶	耳 邑	耳 阝
耷	大 耳
耹	耳 今
耺	耳 云
耼	耳 冄
耽	耳 冘
耾	耳 厷
耿	耳 火
聀	耳 戈
聃	耳 冉
聄	耳 人 彡
聅	耳 矢
聆	耳 令
聇	耳 正
聈	耳 幼
聉	耳 出
聊	耳 卯
聎	耳 兆
聏	耳 而
聐	耳 吉
聑	耳 耳
聒	耳 舌
聕	耳 告
聖	耳 口 王
聗	耳 夾
聘	耳 甹	耳 由 丂
聙	耳 青
聚	耳 又 乑
聛	耳 卑
聜	耳 空
聝	耳 或
聞	門 耳
聟	知 耳
聠	耳 并	耳 幷
聡	耳 忩
聤	耳 亭
聥	耳 禹
聦	耳 葱
聧	耳 癸
聫	耳 幺 幺 大
聬	耳 翁
聭	耳 鬼
聮	耳 幺 幺 火	耳 幺 幺 灬
聯	耳 幺 幺 丱	耳 幺 幺 卯
聰	耳 悤	耳 囱 心
聱	敖 耳
聲	声 殳 耳	殸 耳
聳	從 耳
聴	耳 十 目 心
聵	耳 貴
聶	耳 耳 耳
職	耳 戠
聸	耳 詹
聹	耳 寧
聻	漸 耳
聼	乛 耳 十 目 一 心
聽	耳 王 十 目 一 心
聾	龍 耳
聿	彐 二 丨
肀	彐 丨
肁	戶 聿
肂	歹 聿
肄	匕 矢 聿
肅	聿 片 爿	肀 片 一 爿
肆	镸 聿
肇	戶 攴 聿	户 攴 聿	户 攵 聿	戸 攵 聿
肈	戶 戈 聿
肉	冂 人 人	冂 入 入
肊	肉 乙	月 乙
肋	肉 力	月 力
肌	肉 几	月 几
肍	肉 九	月 九
肎	冖 肉	冖 月
肏	入 肉
肐	肉 乞	月 乞
肑	肉 勺	月 勺
肒	肉 丸	月 丸
肓	亡 肉	亡 月
肔	肉 也	月 也
肕	肉 刃	月 刃
肖	小 肉	小 月
肗	肉 女	月 女
肘	肉 寸	月 寸
肙	口 月
肚	肉 土	月 土
肛	肉 工	月 工
肜	肉 彡	月 彡
肝	肉 干	月 干
肞	肉 义	月 义
肟	肉 亏	月 亏
股	肉 殳	月 殳
肢	肉 支	月 支
肣	肉 今	月 今
肥	肉 巴	月 巴
肦	肉 分	月 分
肧	肉 不	月 不
肨	肉 丰	月 丰
肩	戶 肉	戶 月	户 月	戸 月
肪	肉 方	月 方
肫	肉 屯	月 屯
肬	肉 尤	月 尤
肭	肉 內	月 內
肮	肉 亢	月 亢
肯	止 肉	止 月
肰	肉 犬	月 犬
肱	肉 厷	月 厷
育	亠 厶 肉	亠 厶 月
肳	肉 勿	月 勿
肵	肉 斤	月 斤
肶	肉 比	月 比
肷	肉 欠	月 欠
肸	肉 八 十	月 八 十
肹	肉 兮	月 兮
肺	肉 巿	月 巿
肻	卜 肎	卜 冖 肉	卜 冖 月
肼	肉 井	月 井
肽	肉 太	月 太
胂	肉 申	月 申
胃	田 肉	田 月
胄	由 肉	由 月
胅	肉 失	月 失
胇	肉 弗	月 弗
胈	肉 犮	月 犮
胉	肉 白	月 白
胊	肉 句	月 句
胋	肉 占	月 占
背	北 肉	北 月
胍	肉 瓜	月 瓜
胎	肉 台	月 台
胏	肉 丿 ㇉ 丨 丿	月 丿 ㇉ 丨 丿	肉 𠂔	月 𠂔
胐	肉 出	月 出
胑	肉 只	月 只
胒	肉 尼	月 尼
胓	肉 平	月 平
胔	此 肉	此 月
胕	肉 付	月 付
胖	肉 半	月 半
胗	肉 人 彡	月 人 彡
胘	肉 玄	月 玄
胙	肉 乍	月 乍
胚	肉 丕	月 丕
胛	肉 甲	月 甲
胝	肉 氐	月 氐
胞	肉 包	月 包
胟	肉 母	月 母
胠	肉 去	月 去
胡	古 肉	古 月
胢	肉 可	月 可
胣	肉 丿 一 也	月 丿 一 也
胤	丿 幺 肉 乚	丿 幺 月 乚
胥	疋 月
胦	肉 央	月 央
胩	肉 卡	月 卡
胬	奴 肉	奴 月
胭	肉 因	月 因
胮	肉 夅	月 夅
胯	肉 夸	月 夸
胰	肉 夷	月 夷
胱	肉 光	月 光
胲	肉 亥	月 亥
胳	肉 各	月 各
胴	肉 同	月 同
胵	肉 至	月 至
胷	匈 肉	匈 月
胸	肉 匈	月 匈
胹	肉 而	月 而
胺	肉 安	月 安
胻	肉 行	月 行
能	厶 肉 匕 匕	厶 月 匕 匕
胾	十 戈 肉	土 戈 肉	𢦏 肉
脀	丞 肉	丞 月
脁	肉 兆	月 兆
脂	肉 旨	月 旨
脃	肉 色	月 色
脄	肉 灰	月 灰
脅	劦 肉	劦 月
脆	肉 危	月 危
脇	肉 劦	月 劦
脈	肉 厂 氏	月 厂 氏	肉 𠂢	月 𠂢
脊	肉 人 二 二	月 人 二 二
脎	肉 杀	月 杀
脒	肉 米	月 米
脕	肉 免	月 免
脖	肉 孛	月 孛
脗	肉 勿 口	月 勿 口
脘	肉 完	月 完
脙	肉 求	月 求
脛	肉 巠	月 巠
脜	肉 一 自	月 一 自
脝	肉 亨	月 亨
脞	肉 坐	月 坐
脟	肉 寽	月 寽
脠	肉 延	月 延
脡	肉 廷	月 廷
脢	肉 每	月 每
脣	辰 肉	辰 月
脤	肉 辰	月 辰
脥	肉 夾	月 夾
脦	肉 忒	月 忒
脧	肉 夋	月 夋
脨	肉 束	月 束
脩	攸 肉	攸 月
脪	肉 希	月 希
脫	肉 兌	月 兌
脬	肉 孚	月 孚
脭	肉 呈	月 呈
脮	肉 妥	月 妥
脯	肉 甫	月 甫
脰	肉 豆	月 豆
脲	肉 尿	月 尿
脴	肉 否	月 否
脵	肉 吴	月 吴
脷	肉 利	月 利
脹	肉 長	月 長
脺	肉 卒	月 卒
脼	肉 兩	月 兩
脽	肉 隹	月 隹
脾	肉 卑	月 卑
脿	肉 表	月 表
腀	肉 侖	月 侖
腁	肉 幷	月 幷
腂	肉 果	月 果
腃	肉 卷	月 卷
腄	肉 垂	月 垂
腅	肉 炎	月 炎
腆	肉 典	月 典
腇	肉 委	月 委
腈	肉 青	月 青
腉	肉 兒	月 兒
腋	肉 夜	月 夜
腍	肉 念	月 念
腎	臤 肉	臤 月
腏	肉 叕	月 叕
腐	府 肉	广 付 肉
腑	肉 府	月 府
腒	肉 居	月 居
腓	肉 非	月 非
腔	肉 空	月 空
腕	肉 宛	月 宛
腖	肉 東	月 東
腗	肉 畁	月 畁
腙	肉 宗	月 宗
腚	肉 定	月 定
腛	肉 屋	月 屋
腜	肉 某	月 某
腝	肉 耎	月 耎
腞	肉 彖	月 彖
腟	肉 室	月 室
腠	肉 奏	月 奏
腡	肉 咼	月 咼
腢	肉 禺	月 禺
腣	肉 帝	月 帝
腤	肉 音	月 音
腥	肉 星	月 星
腦	肉 巛 囟	月 巛 囟	肉 𡿺	月 𡿺
腧	肉 俞	月 俞
腨	肉 耑	月 耑
腩	肉 南	月 南
腪	肉 軍	月 軍
腫	肉 重	月 重
腬	肉 柔	月 柔
腭	肉 咢	月 咢
腮	肉 思	月 思
腯	肉 盾	月 盾
腰	肉 要	月 要
腱	肉 建	月 建
腲	肉 畏	月 畏
腳	肉 卻	月 卻
腴	肉 臾	月 臾
腵	肉 叚	月 叚
腶	肉 段	月 段
腷	肉 畐	月 畐
腸	肉 昜	月 昜
腹	肉 复	月 复
腺	肉 泉	月 泉
腿	肉 退	月 退
膀	肉 旁	月 旁
膁	肉 兼	月 兼
膂	旅 肉	旅 月
膃	肉 昷	月 昷
膄	肉 叟	月 叟
膅	肉 唐	月 唐
膆	肉 素	月 素
膇	肉 追	月 追
膈	肉 鬲	月 鬲
膉	肉 益	月 益
膊	肉 尃	月 尃
膋	火 火 冖 肉	火 火 冖 月	𤇾 肉	𤇾 月
膌	肉 脊	月 脊
膍	肉 囟 比	月 囟 比
膎	肉 奚	月 奚
膏	高 肉	高 月
膐	旅 肉	旅 月
膓	肉 丿 一 昜	月 丿 一 昜
膔	肉 鹿	月 鹿
膕	肉 國	月 國
膖	肉 逢	月 逢
膗	肉 崔	月 崔
膘	肉 票	月 票
膙	肉 強	月 強
膚	虎 胃	虍 胃
膛	肉 堂	月 堂
膜	肉 莫	月 莫
膝	肉 桼	月 桼
膞	肉 專	月 專
膟	肉 率	月 率
膠	肉 翏	月 翏
膡	肉 眷	月 眷
膢	肉 婁	月 婁
膣	肉 窒	月 窒
膥	末 成
膦	肉 粦	月 粦
膧	肉 童	月 童
膨	肉 彭	月 彭
膩	肉 貳	月 貳
膪	肉 啻	月 啻
膫	肉 尞	月 尞
膬	肉 毳	月 毳
膭	肉 貴	月 貴
膮	肉 堯	月 堯
膯	肉 登	月 登
膰	肉 番	月 番
膱	肉 戠	月 戠
膲	肉 焦	月 焦
膳	肉 善	月 善
膴	肉 無	月 無
膵	肉 萃	月 萃
膶	肉 閏	月 閏
膷	肉 鄉	月 鄉
膸	肉 遀	月 遀
膹	肉 賁	月 賁
膺	广 人 隹 肉	广 人 隹 月	广 亻 隹 肉	广 倠 肉
膻	肉 亶	月 亶
膼	肉 過	月 過
膽	肉 詹	月 詹
膾	肉 會	月 會
膿	肉 農	月 農
臀	肉 殿	月 殿
臁	肉 廉	月 廉
臂	肉 辟	月 辟
臃	肉 雍	月 雍
臄	肉 豦	月 豦
臅	肉 蜀	月 蜀
臆	肉 意	月 意
臇	肉 雋	月 雋
臈	肉 葛	月 葛
臉	肉 僉	月 僉
臊	肉 喿	月 喿
臋	殿 肉	殿 月
臌	肉 鼓	月 鼓
臍	肉 齊	月 齊
臎	肉 翠	月 翠
臏	肉 賓	月 賓
臐	肉 熏	月 熏
臑	肉 需	月 需
臒	肉 蒦	月 蒦
臓	肉 蔵	月 蔵
臔	肉 賢	月 賢
臕	肉 麃	月 麃
臖	興 肉	興 月
臗	肉 寬	月 寬
臘	肉 巤	月 巤
臙	肉 燕	月 燕
臚	肉 盧	月 盧
臛	肉 霍	月 霍
臝	亡 口 月 果 凡
臞	肉 瞿	月 瞿
臟	肉 藏	月 藏
臠	絲 言 肉	糸 言 糸 肉	䜌 肉
臡	難 肉
臢	肉 贊	月 贊
臣	巨 丨 丨	巨 丶 丶
臤	臣 又
臥	臣 人
臧	一 爿 乀 丿 丶 臣	爿 戊 臣
臨	臣 丿 一 品
臩	臦 夰
自	丶 目
臫	自 乙	自 乚
臬	自 木
臭	自 犬
臮	自 丅 人 人
臯	自 丶 丶 十 丶 丶	自 二 十 二
臰	自 死
臱	自 穴 方
臲	臬 危
至	一 厶 土
致	至 攴	至 攵
臵	至 各
臶	至 存
臷	十 戈 至	土 戈 至	𢦏 至
臸	至 至
臹	至 成
臺	吉 冖 至
臻	至 秦
臼	丿 丨 一 彐
臽	刀 臼
臾	臼 人
臿	千 臼	干 臼
舀	爪 臼	爫 臼
舁	臼 廾
舂	夫 一 臼
舃	臼 一 勹 火 舄	臼 一 勹 灬 舄
舄	臼 勹 火	臼 勹 灬
舅	臼 男
與	臼 一 ㇉ 丶 一 八
興	臼 同 大
舉	與 二 丨	臼 二 丨
舊	草 隹 臼	艸 隹 臼	艹 隹 臼
舋	臼 同 冖 且
舌	千 口
舍	人 舌
舏	舌 丩
舐	舌 氏
舑	舌 冉
舒	舍 予
舓	舌 易
舔	舌 忝
舕	舌 炎
舖	舍 甫
舗	人 土 口 甫	舍 甫
舘	人 舌 官
舙	舌 舌 舌
舚	舌 詹
舛	夕 匸 丨
舜	爪 冖 舛	爫 冖 舛
舝	土 巛 冖 牟
舞	丿 一 卌 一 舛	丿 一 一 丨 丨 丨 丨 一 舛
舟	丶 冂 一 丶 丶	丶 冂 一 丶 丨
舠	舟 刀
舡	舟 工
舢	舟 山
舥	舟 巴
舦	舟 太
舧	舟 凡
舨	舟 反
舩	舟 公
航	舟 亢
舫	舟 方
般	舟 殳
舭	舟 比
舯	舟 中
舲	舟 令
舳	舟 由
舴	舟 乍
舵	舟 它
舶	舟 白
舷	舟 玄
舸	舟 可
船	舟 八 口
舺	舟 甲
舼	舟 共
舽	舟 夅
舾	舟 西
艀	舟 孚
艁	舟 告
艂	舟 夆
艃	舟 里
艄	舟 肖
艅	舟 余
艆	舟 良
艇	舟 廷
艉	舟 尾
艊	舟 帛
艋	舟 孟
艌	舟 念
艍	舟 居
艎	舟 皇
艏	舟 首
艐	舟 凶 八 夕	舟 凶 八 夂
艑	舟 扁
艒	舟 冒
艓	舟 枼
艕	舟 旁
艖	舟 差
艗	舟 益
艘	舟 叟
艙	舟 倉
艚	舟 曹
艛	舟 婁
艜	舟 帶
艞	舟 筄
艟	舟 童
艡	舟 當
艢	舟 嗇
艣	舟 虜
艤	舟 義
艥	舟 咠 戈
艦	舟 監
艧	舟 蒦
艨	舟 蒙
艩	舟 齊
艪	舟 魯
艫	舟 盧
艬	舟 毚
艭	舟 雙
良	丶 艮
艱	革 大 艮
色	刀 巴
艴	弗 色
艵	并 色	幷 色
艶	豊 色
艷	豐 色
艸	屮 屮	山 山
艹	一 丨 丨
艻	草 力	艸 力	艹 力
艼	草 丁	艸 丁	艹 丁
艽	草 九	艸 九	艹 九
艾	草 乂	艸 乂	艹 乂
艿	草 乃	艸 乃	艹 乃
芀	草 刀	艸 刀	艹 刀
芁	草 几	艸 几	艹 几
芃	草 凡	艸 凡	艹 凡
芄	草 丸	艸 丸	艹 丸
芅	草 弋	艸 弋	艹 弋
芆	草 叉	艸 叉	艹 叉
芇	草 巾	艸 巾	艹 巾
芈	草 卝 二 丨	艸 卝 二 丨	艹 卝 二 丨
芉	草 干	艸 干	艹 干
芊	草 千	艸 千	艹 千
芋	草 于	艸 于	艹 于
芌	草 亏	艸 亏	艹 亏
芍	草 勺	艸 勺	艹 勺
芎	草 弓	艸 弓	艹 弓
芏	草 土	艸 土	艹 土
芐	草 下	艸 下	艹 下
芑	草 己	艸 己	艹 己
芒	草 亡	艸 亡	艹 亡
芓	草 子	艸 子	艹 子
芔	屮 屮 屮	屮 艸
芕	草 夕	艸 夕	艹 夕
芖	草 大	艸 大	艹 大
芘	草 比	艸 比	艹 比
芙	草 夫	艸 夫	艹 夫
芚	草 屯	艸 屯	艹 屯
芛	草 尹	艸 尹	艹 尹
芝	草 之	艸 之	艹 之
芞	草 气	艸 气	艹 气
芟	草 殳	艸 殳	艹 殳
芠	草 文	艸 文	艹 文
芡	草 欠	艸 欠	艹 欠
芢	草 仁	艸 仁	艹 仁
芣	草 不	艸 不	艹 不
芤	草 孔	艸 孔	艹 孔
芥	草 介	艸 介	艹 介
芧	草 予	艸 予	艹 予
芨	草 及	艸 及	艹 及
芩	草 今	艸 今	艹 今
芪	草 氏	艸 氏	艹 氏
芫	草 元	艸 元	艹 元
芬	草 分	艸 分	艹 分
芭	草 巴	艸 巴	艹 巴
芮	草 內	艸 內	艹 內
芯	草 心	艸 心	艹 心
芰	草 支	艸 支	艹 支
花	草 化	艸 化	艹 化
芲	草 人 七	艸 人 七	艹 人 七
芳	草 方	艸 方	艹 方
芴	草 勿	艸 勿	艹 勿
芵	草 夬	艸 夬	艹 夬
芶	草 勾	艸 勾	艹 勾
芷	草 止	艸 止	艹 止
芸	草 云	艸 云	艹 云
芹	草 斤	艸 斤	艹 斤
芺	草 夭	艸 夭	艹 夭
芻	勹 屮 勹 屮	勹 勹 草 草	勹 勹 艸
芼	草 毛	艸 毛	艹 毛
芽	草 牙	艸 牙	艹 牙
芾	草 巿	艸 巿	艹 巿
芿	草 仍	艸 仍	艹 仍
苀	草 亢	艸 亢	艹 亢
苂	草 火	艸 火	艹 火
苃	草 友	艸 友	艹 友
苄	草 卞	艸 卞	艹 卞
苅	草 刈	艸 刈	艹 刈
苉	草 匹	艸 匹	艹 匹
苊	草 厄	艸 厄	艹 厄
苐	草 弔	艸 弔	艹 弔
苑	草 夗	艸 夗	艹 夗
苒	草 冉	艸 冉	艹 冉
苓	草 令	艸 令	艹 令
苔	草 台	艸 台	艹 台
苕	草 召	艸 召	艹 召
苖	草 由	艸 由	艹 由
苗	草 田	艸 田	艹 田
苘	草 冋	艸 冋	艹 冋
苙	草 立	艸 立	艹 立
苚	草 用	艸 用	艹 用
苛	草 可	艸 可	艹 可
苜	草 目	艸 目	艹 目
苝	草 北	艸 北	艹 北
苞	草 包	艸 包	艹 包
苟	草 句	艸 句	艹 句
苠	草 民	艸 民	艹 民
苡	草 以	艸 以	艹 以
苢	草 尸 乛 一	艸 尸 乛 一	艹 尸 乛 一
苣	草 巨	艸 巨	艹 巨
苤	草 丕	艸 丕	艹 丕
若	草 右	艸 右	艹 右
苦	草 古	艸 古	艹 古
苧	草 宁	艸 宁	艹 宁
苨	草 尼	艸 尼	艹 尼
苩	草 白	艸 白	艹 白
苪	草 丙	艸 丙	艹 丙
苫	草 占	艸 占	艹 占
苬	草 囚	艸 囚	艹 囚
苭	草 幼	艸 幼	艹 幼
苮	草 仙	艸 仙	艹 仙
苯	草 本	艸 本	艹 本
苰	草 弘	艸 弘	艹 弘
英	草 央	艸 央	艹 央
苲	草 乍	艸 乍	艹 乍
苳	草 冬	艸 冬	艹 冬
苴	草 且	艸 且	艹 且
苵	草 失	艸 失	艹 失
苶	草 尒	艸 尒	艹 尒
苷	草 甘	艸 甘	艹 甘
苸	草 乎	艸 乎	艹 乎
苺	草 母	艸 母	艹 母
苻	草 付	艸 付	艹 付
苼	草 生	艸 生	艹 生
苽	草 瓜	艸 瓜	艹 瓜
苾	草 必	艸 必	艹 必
苿	草 未	艸 未	艹 未
茀	草 弗	艸 弗	艹 弗
茁	草 出	艸 出	艹 出
茂	草 戊	艸 戊	艹 戊
范	草 氾	艸 氾	艹 氾
茄	草 加	艸 加	艹 加
茅	草 矛	艸 矛	艹 矛
茆	草 卯	艸 卯	艹 卯
茇	草 犮	艸 犮	艹 犮
茈	草 此	艸 此	艹 此
茉	草 末	艸 末	艹 末
茊	草 丘	艸 丘	艹 丘
茋	草 氐	艸 氐	艹 氐
茌	草 仕	艸 仕	艹 仕
茍	草 句	艸 句	艹 句
茓	草 穴	艸 穴	艹 穴
茖	草 各	艸 各	艹 各
茗	草 名	艸 名	艹 名
茘	草 刕	艸 刕	艹 刕
茙	草 戎	艸 戎	艹 戎
茚	草 印	艸 印	艹 印
茛	草 艮	艸 艮	艹 艮
茜	草 西	艸 西	艹 西
茝	草 臣	艸 臣	艹 臣
茞	草 臣	艸 臣	艹 臣
茟	草 聿	艸 聿	艹 聿
茠	草 休	艸 休	艹 休
茡	草 字	艸 字	艹 字
茢	草 列	艸 列	艹 列
茣	草 吳	艸 吳	艹 吳
茤	草 多	艸 多	艹 多
茥	草 圭	艸 圭	艹 圭
茦	草 朿	艸 朿	艹 朿
茨	草 次	艸 次	艹 次
茩	草 后	艸 后	艹 后
茪	草 光	艸 光	艹 光
茫	草 水 亡	艸 氵 亡	艹 氵 亡
茬	草 在	艸 在	艹 在
茭	草 交	艸 交	艹 交
茮	草 尗	艸 尗	艹 尗
茯	草 伏	艸 伏	艹 伏
茰	草 由 乂	艸 由 乂	艹 由 乂
茱	草 朱	艸 朱	艹 朱
茲	草 幺 幺	艸 幺 幺	艹 幺 幺
茳	草 江	艸 江	艹 江
茴	草 回	艸 回	艹 回
茵	草 因	艸 因	艹 因
茶	草 人 一 小	艸 人 一 小	艹 人 一 小
茷	草 伐	艸 伐	艹 伐
茸	草 耳	艸 耳	艹 耳
茹	草 如	艸 如	艹 如
茺	草 充	艸 充	艹 充
茻	屮 屮 屮 屮	艸 艸
茼	草 同	艸 同	艹 同
茽	草 仲	艸 仲	艹 仲
茿	草 巩	艸 巩	艹 巩
荀	草 旬	艸 旬	艹 旬
荁	草 亘	艸 亘	艹 亘
荂	草 夸	艸 夸	艹 夸
荃	草 全	艸 全	艹 全
荄	草 亥	艸 亥	艹 亥
荅	草 合	艸 合	艹 合
荇	草 行	艸 行	艹 行
荈	草 舛	艸 舛	艹 舛
草	草 早	艸 早	艹 早
荊	草 开 刀	艸 开 刂	艹 开 刂
荋	草 而	艸 而	艹 而
荌	草 安	艸 安	艹 安
荍	草 收	艸 收	艹 收
荎	草 至	艸 至	艹 至
荏	草 任	艸 任	艹 任
荑	草 夷	艸 夷	艹 夷
荒	草 巟	艸 巟	艹 巟
荓	草 并	艸 并	艹 并	草 幷	艸 幷	艹 幷
荔	草 劦	艸 劦	艹 劦
荕	草 肋	艸 肋	艹 肋
荖	草 老	艸 老	艹 老
荗	草 戍	艸 戍	艹 戍
荘	草 壮	艸 壮	艹 壮
荰	草 杜	艸 杜	艹 杜
荱	草 尾	艸 尾	艹 尾
荲	草 里	艸 里	艹 里
荳	草 豆	艸 豆	艹 豆
荴	草 扶	艸 扶	艹 扶
荵	草 忍	艸 忍	艹 忍
荶	草 吟	艸 吟	艹 吟
荷	草 何	艸 何	艹 何
荸	草 孛	艸 孛	艹 孛
荹	草 步	艸 步	艹 步
荺	草 均	艸 均	艹 均
荻	草 狄	艸 狄	艹 狄
荼	草 余	艸 余	艹 余
荽	草 妥	艸 妥	艹 妥
荾	草 夋	艸 夋	艹 夋
荿	草 成	艸 成	艹 成
莀	草 辰	艸 辰	艹 辰
莁	草 巫	艸 巫	艹 巫
莂	草 別	艸 別	艹 別	草 别	艸 别	艹 别
莃	草 希	艸 希	艹 希
莄	草 更	艸 更	艹 更
莆	草 甫	艸 甫	艹 甫
莇	草 助	艸 助	艹 助
莈	草 沒	艸 沒	艹 沒
莉	草 利	艸 利	艹 利
莊	草 壯	艸 壯	艹 壯
莋	草 作	艸 作	艹 作
莌	草 兌	艸 兌	艹 兌
莍	草 求	艸 求	艹 求
莎	草 沙	艸 沙	艹 沙
莏	草 抄	艸 抄	艹 抄
莐	草 沈	艸 沈	艹 沈
莑	草 夆	艸 夆	艹 夆
莒	草 呂	艸 呂	艹 呂
莓	草 每	艸 每	艹 每
莔	草 囧	艸 囧	艹 囧
莕	草 杏	艸 杏	艹 杏
莖	草 巠	艸 巠	艹 巠
莗	草 車	艸 車	艹 車
莘	草 辛	艸 辛	艹 辛
莙	草 君	艸 君	艹 君
莚	草 延	艸 延	艹 延
莛	草 廷	艸 廷	艹 廷
莜	草 攸	艸 攸	艹 攸
莝	草 坐	艸 坐	艹 坐
莞	草 完	艸 完	艹 完
莟	草 今	艸 今	艹 今
莠	草 秀	艸 秀	艹 秀
莡	草 足	艸 足	艹 足
莢	草 夾	艸 夾	艹 夾
莣	草 忘	艸 忘	艹 忘
莤	草 酉	艸 酉	艹 酉
莥	草 狃	艸 狃	艹 狃
莦	草 肖	艸 肖	艹 肖
莧	草 見	艸 見	艹 見
莨	草 良	艸 良	艹 良
莩	草 孚	艸 孚	艹 孚
莪	草 我	艸 我	艹 我
莫	草 日 大	艸 日 大	艹 日 大	艹 曰 大
莬	草 免	艸 免	艹 免
莭	草 即	艸 即	艹 即
莮	草 男	艸 男	艹 男
莯	草 沐	艸 沐	艹 沐
莰	草 坎	艸 坎	艹 坎
莽	草 大 廾	艸 大 廾	艹 大 廾
莾	草 奔	艸 奔	艹 奔
莿	草 刺	艸 刺	艹 刺
菀	草 宛	艸 宛	艹 宛
菁	草 青	艸 青	艹 青
菂	草 的	艸 的	艹 的
菃	草 洰	艸 洰	艹 洰
菄	草 東	艸 東	艹 東
菅	草 官	艸 官	艹 官
菆	草 取	艸 取	艹 取
菇	草 姑	艸 姑	艹 姑
菈	草 拉	艸 拉	艹 拉
菉	草 彔	艸 彔	艹 彔
菊	草 匊	艸 匊	艹 匊	草 勹 米
菋	草 味	艸 味	艹 味
菌	草 囷	艸 囷	艹 囷
菍	草 念	艸 念	艹 念
菎	草 昆	艸 昆	艹 昆
菏	草 河	艸 河	艹 河
菐	业 丷 三 人
菑	草 甾	艸 甾	艹 甾
菒	草 杲	艸 杲	艹 杲
菓	草 果	艸 果	艹 果
菔	草 服	艸 服	艹 服
菕	草 侖	艸 侖	艹 侖
菖	草 昌	艸 昌	艹 昌
菗	草 抽	艸 抽	艹 抽
菘	草 松	艸 松	艹 松
菙	草 垂	艸 垂	艹 垂
菚	草 戔	艸 戔	艹 戔
菛	草 門	艸 門	艹 門
菜	草 采	艸 采	艹 采
菝	草 犮	艸 犮	艹 犮
菞	草 禾 勹 丿	艸 禾 勹 丿	艹 禾 勹 丿
菟	草 兔	艸 兔	艹 兔
菠	草 波	艸 波	艹 波
菡	草 函	艸 函	艹 函
菢	草 抱	艸 抱	艹 抱
菣	草 臣 又	艸 臣 又	艹 臣 又
菤	草 卷	艸 卷	艹 卷
菥	草 析	艸 析	艹 析
菦	草 近	艸 近	艹 近
菧	草 底	艸 底	艹 底
菨	草 妾	艸 妾	艹 妾
菩	草 咅	艸 咅	艹 咅
菪	草 宕	艸 宕	艹 宕
菫	草 丅 口 三	艸 丅 口 三	艹 丅 口 三
菬	草 沼	艸 沼	艹 沼
菭	草 治	艸 治	艹 治
菮	草 庚	艸 庚	艹 庚
華	草 一 草 一 十	艸 一 艹 一 十	艹 一 艹 一 十
菰	草 孤	艸 孤	艹 孤
菱	草 夌	艸 夌	艹 夌
菲	草 非	艸 非	艹 非
菳	草 金	艸 金	艹 金
菴	草 奄	艸 奄	艹 奄
菵	草 罔	艸 罔	艹 罔
菶	草 奉	艸 奉	艹 奉
菷	草 帚	艸 帚	艹 帚
菸	草 於	艸 於	艹 於
菹	草 沮	艸 沮	艹 沮
菺	草 肩	艸 肩	艹 肩
菻	草 林	艸 林	艹 林
菼	草 炎	艸 炎	艹 炎
菽	草 叔	艸 叔	艹 叔
菾	草 忝	艸 忝	艹 忝
菿	草 到	艸 到	艹 到
萀	草 虎	艸 虎	艹 虎
萁	草 其	艸 其	艹 其
萂	草 和	艸 和	艹 和
萃	草 卒	艸 卒	艹 卒
萄	草 匋	艸 匋	艹 匋
萅	草 旾	艸 旾	艹 旾
萆	草 卑	艸 卑	艹 卑
萇	草 長	艸 長	艹 長
萈	草 見 丶	艸 見 丶	艹 見 丶
萉	草 肥	艸 肥	艹 肥
萊	草 來	艸 來	艹 來
萋	草 妻	艸 妻	艹 妻
萌	草 明	艸 明	艹 明
萍	草 水 平	艸 氵 平	艹 氵 平
萎	草 委	艸 委	艹 委
萏	草 臽	艸 臽	艹 臽
萐	草 疌	艸 疌	艹 疌
萒	草 兖	艸 兖	艹 兖
萓	草 宜	艸 宜	艹 宜
萔	草 招	艸 招	艹 招
萕	草 斉	艸 斉	艹 斉
萖	草 兒	艸 兒	艹 兒
萗	草 宗	艸 宗	艹 宗
萘	草 奈	艸 奈	艹 奈
萛	草 目 廾	艸 目 廾	艹 目 廾
萜	草 帖	艸 帖	艹 帖
萠	草 朋	艸 朋	艹 朋
萩	草 秋	艸 秋	艹 秋
萪	草 科	艸 科	艹 科
萫	草 香	艸 香	艹 香
萬	草 禺	艸 禺	艹 禺
萭	草 禹	艸 禹	艹 禹
萮	草 俞	艸 俞	艹 俞
萯	草 負	艸 負	艹 負
萰	草 柬	艸 柬	艹 柬
萱	草 宣	艸 宣	艹 宣
萲	草 爰	艸 爰	艹 爰
萳	草 南	艸 南	艹 南
萴	草 則	艸 則	艹 則
萵	草 咼	艸 咼	艹 咼
萶	草 春	艸 春	艹 春
萷	草 削	艸 削	艹 削
萸	草 臾	艸 臾	艹 臾
萹	草 扁	艸 扁	艹 扁
萺	草 冒	艸 冒	艹 冒
萻	草 音	艸 音	艹 音
萼	草 咢	艸 咢	艹 咢
落	草 洛	艸 洛	艹 洛
萾	草 盈	艸 盈	艹 盈
萿	草 活	艸 活	艹 活
葀	草 括	艸 括	艹 括
葁	草 姜	艸 姜	艹 姜
葂	草 勉	艸 勉	艹 勉
葃	草 昨	艸 昨	艹 昨
葄	草 胙	艸 胙	艹 胙
葅	草 俎	艸 俎	艹 俎
葆	草 保	艸 保	艹 保
葇	草 柔	艸 柔	艹 柔
葈	草 枲	艸 枲	艹 枲	苔 木
葉	草 枼	艸 枼	艹 枼	草 世 木
葊	草 弇	艸 弇	艹 弇
葋	草 朐	艸 朐	艹 朐
葌	草 姦	艸 姦	艹 姦
葍	草 畐	艸 畐	艹 畐
葎	草 律	艸 律	艹 律
葏	草 津	艸 津	艹 津
葐	草 盆	艸 盆	艹 盆	芬 皿
葑	草 封	艸 封	艹 封
葒	草 紅	艸 紅	艹 紅
葓	草 洪	艸 洪	艹 洪
葔	草 侯	艸 侯	艹 侯
葕	草 衍	艸 衍	艹 衍
葖	草 突	艸 突	艹 突
著	草 者	艸 者	艹 者
著	草 者	艸 者	艹 者
葘	草 甾 一	艸 甾 一	艹 甾 一
葙	草 相	艸 相	艹 相
葚	草 甚	艸 甚	艹 甚
葛	草 曷	艸 曷	艹 曷
葜	草 契	艸 契	艹 契
葝	草 勁	艸 勁	艹 勁
葞	草 弭	艸 弭	艹 弭
葟	草 皇	艸 皇	艹 皇
葠	草 侵	艸 侵	艹 侵
葡	草 匍	艸 匍	艹 匍
葢	草 盇	艸 盇	艹 盇
董	草 重	艸 重	艹 重
葤	草 紂	艸 紂	艹 紂
葥	草 前	艸 前	艹 前
葦	草 韋	艸 韋	艹 韋
葧	草 勃	艸 勃	艹 勃
葨	草 畏	艸 畏	艹 畏
葩	草 皅	艸 皅	艹 皅
葪	草 角 刀	艸 角 刂	艹 角 刂
葫	草 胡	艸 胡	艹 胡
葬	草 死 廾	艸 死 廾	艹 死 廾
葭	草 叚	艸 叚	艹 叚
葮	草 段	艸 段	艹 段
葯	草 約	艸 約	艹 約
葰	草 俊	艸 俊	艹 俊
葲	草 泉	艸 泉	艹 泉
葳	草 威	艸 威	艹 威
葴	草 咸	艸 咸	艹 咸
葵	草 癸	艸 癸	艹 癸
葶	草 亭	艸 亭	艹 亭
葷	草 軍	艸 軍	艹 軍
葸	草 思	艸 思	艹 思
葹	草 施	艸 施	艹 施
葺	草 咠	艸 咠	艹 咠	草 口 耳
葻	草 風	艸 風	艹 風
葼	草 凶 八 夕	艸 凶 八 夂	艹 凶 八 夂
葽	草 要	艸 要	艹 要
葾	草 怨	艸 怨	艹 怨	苑 心
葿	草 眉	艸 眉	艹 眉
蒁	草 述	艸 述	艹 述
蒂	草 帝	艸 帝	艹 帝
蒃	草 彖	艸 彖	艹 彖
蒄	草 冠	艸 冠	艹 冠
蒆	草 巩 女	艸 巩 女	艹 巩 女
蒈	草 皆	艸 皆	艹 皆
蒍	草 為	艸 為	艹 為
蒎	草 派	艸 派	艹 派
蒐	草 鬼	艸 鬼	艹 鬼
蒑	草 殷	艸 殷	艹 殷
蒒	草 師	艸 師	艹 師
蒓	草 純	艸 純	艹 純
蒔	草 時	艸 時	艹 時
蒕	草 昷	艸 昷	艹 昷
蒖	草 真	艸 真	艹 真
蒗	草 浪	艸 浪	艹 浪
蒘	草 挐	艸 挐	艹 挐	茹 手
蒙	草 冡	艸 冡	艹 冡
蒚	草 鬲	艸 鬲	艹 鬲
蒛	草 缺	艸 缺	艹 缺
蒜	草 示 示	艸 示 示	艹 示 示
蒝	草 原	艸 原	艹 原
蒞	草 水 位	艸 氵 位	艹 氵 位
蒟	草 立 句	艸 立 句	艹 立 句
蒠	草 息	艸 息	艹 息
蒡	草 旁	艸 旁	艹 旁
蒢	草 除	艸 除	艹 除
蒣	草 徐	艸 徐	艹 徐
蒤	草 涂	艸 涂	艹 涂
蒥	草 留	艸 留	艹 留
蒦	草 隻	草 隹 又	艸 隻	艹 隻
蒧	草 戊 占	艸 戊 占	艹 戊 占
蒨	草 倩	艸 倩	艹 倩
蒩	草 租	艸 租	艹 租
蒪	草 尃	艸 尃	艹 尃
蒫	草 差	艸 差	艹 差
蒬	草 冤	艸 冤	艹 冤
蒭	草 芻	艸 芻	艹 芻
蒮	草 隺	艸 隺	艹 隺
蒯	萠 刀	萠 刂
蒰	草 般	艸 般	艹 般
蒱	草 捕	艸 捕	艹 捕
蒲	草 浦	艸 浦	艹 浦
蒳	草 納	艸 納	艹 納
蒴	草 朔	艸 朔	艹 朔
蒵	草 奚	艸 奚	艹 奚
蒶	草 紛	艸 紛	艹 紛
蒷	草 員	艸 員	艹 員
蒸	草 烝	艸 烝	艹 烝
蒹	草 兼	艸 兼	艹 兼
蒺	草 疾	艸 疾	艹 疾
蒻	草 弱	艸 弱	艹 弱
蒼	草 倉	艸 倉	艹 倉
蒽	草 恩	艸 恩	艹 恩
蒾	草 迷	艸 迷	艹 迷
蒿	草 高	艸 高	艹 高
蓀	草 孫	艸 孫	艹 孫
蓁	草 秦	艸 秦	艹 秦
蓂	草 冥	艸 冥	艹 冥
蓃	草 叟	艸 叟	艹 叟
蓄	草 畜	艸 畜	艹 畜
蓅	草 流	艸 流	艹 流
蓆	草 席	艸 席	艹 席
蓇	草 骨	艸 骨	艹 骨
蓈	草 郎	艸 郎	艹 郎
蓉	草 容	艸 容	艹 容
蓊	草 翁	艸 翁	艹 翁
蓋	草 盍	艸 盍	艹 盍	艹 去 皿
蓌	草 夎	艸 夎	艹 夎	莝 夊
蓍	草 耆	艸 耆	艹 耆
蓎	草 唐	艸 唐	艹 唐
蓏	草 瓜 瓜	艸 瓜 瓜	艹 瓜 瓜
蓐	草 辱	艸 辱	艹 辱
蓑	草 衰	艸 衰	艹 衰
蓒	草 軒	艸 軒	艹 軒
蓓	草 倍	艸 倍	艹 倍
蓔	草 羔	艸 羔	艹 羔
蓕	草 桂	艸 桂	艹 桂
蓖	草 囟 比	艸 囟 比	艹 囟 比
蓗	草 徒	艸 徒	艹 徒
蓚	草 修	艸 修	艹 修
蓛	草 敇	艸 敇	艹 敇
蓡	草 浸	艸 浸	艹 浸
蓢	草 朗	艸 朗	艹 朗
蓧	草 條	艸 條	艹 條
蓨	草 攸 月	艸 攸 月	艹 攸 月
蓩	草 務	艸 務	艹 務
蓪	草 通	艸 通	艹 通
蓫	草 逐	艸 逐	艹 逐
蓬	草 逢	艸 逢	艹 逢
蓭	草 庵	艸 庵	艹 庵
蓮	草 連	艸 連	艹 連
蓯	草 從	艸 從	艹 從
蓰	草 徙	艸 徙	艹 徙
蓱	草 洴	艸 洴	艹 洴
蓲	草 區	艸 區	艹 區
蓳	草 堇	艸 堇	艹 堇
蓴	草 專	艸 專	艹 專
蓵	草 捷	艸 捷	艹 捷
蓶	草 唯	艸 唯	艹 唯
蓷	草 推	艸 推	艹 推
蓸	草 曹	艸 曹	艹 曹
蓹	草 御	艸 御	艹 御
蓺	草 埶	艸 埶	艹 埶
蓻	草 執	艸 執	艹 執
蓼	草 翏	艸 翏	艹 翏
蓽	草 畢	艸 畢	艹 畢
蓾	草 鹵	艸 鹵	艹 鹵
蓿	草 宿	艸 宿	艹 宿
蔀	草 部	艸 部	艹 部
蔁	草 章	艸 章	艹 章
蔂	草 累	艸 累	艹 累
蔃	草 强	艸 强	艹 强
蔄	草 問	艸 問	艹 問
蔅	草 門 女	艸 門 女	艹 門 女
蔆	草 淩	艸 淩	艹 淩
蔇	草 既	艸 既	艹 既
蔈	草 票	艸 票	艹 票
蔉	草 袞	艸 袞	艹 袞
蔊	草 焊	艸 焊	艹 焊
蔋	草 淑	艸 淑	艹 淑
蔌	草 欶	艸 欶	艹 欶
蔍	草 鹿	艸 鹿	艹 鹿
蔎	草 設	艸 設	艹 設
蔏	草 商	艸 商	艹 商
蔐	草 啇	艸 啇	艹 啇
蔑	草 网 戍	艸 罓 戍	艹 罒 戍
蔒	草 焄	艸 焄	艹 焄
蔓	草 曼	艸 曼	艹 曼
蔔	草 匐	艸 匐	艹 匐
蔕	草 帶	艸 帶	艹 帶
蔖	草 虘	艸 虘	艹 虘
蔗	草 庶	艸 庶	艹 庶
蔘	草 參	艸 參	艹 參
蔙	草 旋	艸 旋	艹 旋
蔚	草 尉	艸 尉	艹 尉
蔛	草 斛	艸 斛	艹 斛	草 角 斗	艸 角 斗	艹 角 斗
蔜	草 敖	艸 敖	艹 敖
蔝	草 眯	艸 眯	艹 眯
蔞	草 婁	艸 婁	艹 婁
蔟	草 族	艸 族	艹 族
蔠	草 終	艸 終	艹 終
蔡	草 祭	艸 祭	艹 祭
蔢	草 婆	艸 婆	艹 婆
蔣	草 將	艸 將	艹 將
蔤	草 密	艸 密	艹 密
蔥	草 悤	艸 悤	艹 悤
蔦	草 鳥	艸 鳥	艹 鳥
蔧	草 彗	艸 彗	艹 彗
蔨	草 圈	艸 圈	艹 圈
蔩	草 寅	艸 寅	艹 寅
蔪	草 斬	艸 斬	艹 斬
蔫	草 焉	艸 焉	艹 焉
蔬	草 疏	艸 疏	艹 疏
蔭	草 陰	艸 陰	艹 陰
蔮	草 國	艸 國	艹 國
蔯	草 陳	艸 陳	艹 陳
蔰	草 扈	艸 扈	艹 扈
蔱	草 殺	艸 殺	艹 殺
蔲	草 寇	艸 寇	艹 寇
蔳	草 清	艸 清	艹 清
蔴	草 麻	艸 麻	艹 麻
蔵	草 戉 臣	艸 戉 臣	艹 戉 臣
蔸	草 兜	艸 兜	艹 兜
蔻	草 寇	艸 寇	艹 寇
蔽	草 敝	艸 敝	艹 敝
蔾	菞 木
蔿	草 爲	艸 爲	艹 爲
蕀	草 棘	艸 棘	艹 棘
蕁	草 尋	艸 尋	艹 尋
蕂	草 勝	艸 勝	艹 勝
蕃	草 番	艸 番	艹 番
蕄	草 悶	艸 悶	艹 悶
蕅	草 湡	艸 湡	艹 湡
蕆	草 戊 貝	艸 戊 貝	艹 戊 貝
蕇	草 單	艸 單	艹 單
蕈	草 覃	艸 覃	艹 覃
蕉	草 焦	艸 焦	艹 焦
蕊	草 惢	艸 惢	艹 惢	芯 心 心
蕋	草 歮	艸 歮	艹 歮
蕌	草 畾	艸 畾	艹 畾
蕍	草 渝	艸 渝	艹 渝
蕎	草 喬	艸 喬	艹 喬
蕐	草 二 人 人 人 人 十	艸 二 人 人 人 人 十	艹 二 人 人 人 人 十
蕑	草 閒	艸 閒	艹 閒
蕒	草 買	艸 買	艹 買
蕓	草 雲	艸 雲	艹 雲
蕔	草 報	艸 報	艹 報
蕕	草 猶	艸 猶	艹 猶
蕖	草 渠	艸 渠	艹 渠
蕗	草 路	艸 路	艹 路
蕘	草 堯	艸 堯	艹 堯
蕙	草 惠	艸 惠	艹 惠
蕚	草 品 亏	艸 品 亏	艹 品 亏	草 口 咢	艸 口 咢	艹 口 咢
蕛	草 稊	艸 稊	艹 稊
蕜	草 悲	艸 悲	艹 悲	菲 心
蕝	草 絕	艸 絕	艹 絕
蕞	草 最	艸 最	艹 最
蕟	草 發	艸 發	艹 發
蕠	草 絮	艸 絮	艹 絮
蕡	草 賁	艸 賁	艹 賁
蕢	草 貴	艸 貴	艹 貴
蕣	草 舜	艸 舜	艹 舜
蕤	草 豕 生	艸 豕 生	艹 豕 生
蕥	草 雅	艸 雅	艹 雅
蕦	草 須	艸 須	艹 須
蕧	草 復	艸 復	艹 復
蕨	草 厥	艸 厥	艹 厥
蕩	草 湯	艸 湯	艹 湯
蕪	草 無	艸 無	艹 無
蕫	草 童	艸 童	艹 童
蕬	草 絲	艸 絲	艹 絲
蕭	草 肅	艸 肅	艹 肅
蕮	草 舄	艸 舄	艹 舄
蕯	草 隆	艸 隆	艹 隆
蕳	草 間	艸 間	艹 間
蕵	草 飧	艸 飧	艹 飧
蕶	草 零	艸 零	艹 零
蕷	草 預	艸 預	艹 預
蕸	草 遐	艸 遐	艹 遐
蕹	草 雍	艸 雍	艹 雍
蕺	草 戢	艸 戢	艹 戢
蕻	草 镸 共	艸 镸 共	艹 镸 共
蕼	草 肆	艸 肆	艹 肆
蕽	草 農	艸 農	艹 農
蕾	草 雷	艸 雷	艹 雷
蕿	草 煖	艸 煖	艹 煖
薀	草 溫	艸 溫	艹 溫
薁	草 奧	艸 奧	艹 奧
薂	草 敫	艸 敫	艹 敫
薃	草 滈	艸 滈	艹 滈
薄	草 水 甫 寸	艸 氵 尃	艹 氵 尃
薅	草 媷	艸 媷	艹 媷
薆	草 愛	艸 愛	艹 愛
薇	草 微	艸 微	艹 微
薈	草 會	艸 會	艹 會
薉	草 歲	艸 歲	艹 歲
薊	草 魚 刀	艸 魚 刂	艹 魚 刂
薋	草 資	艸 資	艹 資
薌	草 鄉	艸 鄉	艹 鄉
薍	草 亂	艸 亂	艹 亂
薎	草 卝	艸 卝	艹 卝
薏	草 意	艸 意	艹 意
薐	草 稜	艸 稜	艹 稜
薑	草 畺	艸 畺	艹 畺
薒	草 粲	艸 粲	艹 粲
薓	草 水 帚 又	艸 氵 帚 又	艹 氵 帚 又
薔	草 嗇	艸 嗇	艹 嗇
薕	草 廉	艸 廉	艹 廉
薖	草 過	艸 過	艹 過
薗	草 園	艸 園	艹 園
薘	草 達	艸 達	艹 達
薙	草 雉	艸 雉	艹 雉
薚	草 歹 昜	艸 歹 昜	艹 歹 昜
薛	草 戶 乛 一 辛	艸 戶 乛 一 辛	艹 戶 乛 一 辛
薜	草 辟	艸 辟	艹 辟
薝	草 詹	艸 詹	艹 詹
薞	草 飱	艸 飱	艹 飱
薟	草 僉	艸 僉	艹 僉
薠	草 煩	艸 煩	艹 煩
薡	草 鼎	艸 鼎	艹 鼎
薢	草 解	艸 解	艹 解
薣	草 鼓	艸 鼓	艹 鼓
薤	草 歹 韭	艸 歹 韭	艹 歹 韭
薥	草 蜀	艸 蜀	艹 蜀
薦	草 廌	艸 廌	艹 廌
薧	草 亠 口 冂 死	艸 亠 口 冂 死	艹 亠 口 冂 死
薨	草 网 冖 死	艸 罒 冖 死	艹 罒 冖 死
薩	草 阜 產	艸 阜 產	艹 阝 產
薪	草 新	艸 新	艹 新
薫	草 重 火	艸 重 灬	艹 重 灬
薬	草 楽	艸 楽	艹 楽
薯	草 署	艸 署	艹 署
薰	草 熏	艸 熏	艹 熏
薱	草 對	艸 對	艹 對
薲	草 賓	艸 賓	艹 賓
薳	草 遠	艸 遠	艹 遠
薴	草 寧	艸 寧	艹 寧
薵	草 壽	艸 壽	艹 壽
薶	草 貍	艸 貍	艹 貍
薷	草 需	艸 需	艹 需
薸	草 漂	艸 漂	艹 漂
薹	草 臺	艸 臺	艹 臺
薺	草 齊	艸 齊	艹 齊
薻	草 漅	艸 漅	艹 漅
薼	草 塵	艸 塵	艹 塵
薽	草 甄	艸 甄	艹 甄
薾	草 爾	艸 爾	艹 爾
薿	草 疑	艸 疑	艹 疑
藀	草 熒	艸 熒	艹 熒
藁	草 槀	艸 槀	艹 槀	蒿 木
藂	草 聚	艸 聚	艹 聚
藃	草 歊	艸 歊	艹 歊
藄	草 綦	艸 綦	艹 綦
藅	草 罰	艸 罰	艹 罰
藆	草 搴	艸 搴	艹 搴
藇	草 與	艸 與	艹 與
藈	草 睽	艸 睽	艹 睽
藉	草 耤	艸 耤	艹 耤
藊	草 稨	艸 稨	艹 稨
藋	草 翟	艸 翟	艹 翟
藌	草 蜜	艸 蜜	艹 蜜
藍	草 監	艸 監	艹 監
藎	草 盡	艸 盡	艹 盡
藏	草 臧	艸 臧	艹 臧
藐	草 貌	艸 貌	艹 貌
藑	草 夐	艸 夐	艹 夐
藒	草 禾 曷	艸 禾 曷	艹 禾 曷
藕	草 耦	艸 耦	艹 耦
藖	草 賢	艸 賢	艹 賢
藗	草 遬	艸 遬	艹 遬
藘	草 慮	艸 慮	艹 慮
藙	草 毅	艸 毅	艹 毅
藚	草 賣	艸 賣	艹 賣
藛	草 寫	艸 寫	艹 寫
藜	草 黎	艸 黎	艹 黎
藝	草 埶 云	艸 埶 云	艹 埶 云	草 執 云
藞	草 磊	艸 磊	艹 磊
藟	草 畾	艸 畾	艹 畾
藠	草 皛	艸 皛	艹 皛
藡	草 適	艸 適	艹 適
藢	草 徵	艸 徵	艹 徵
藣	草 罷	艸 罷	艹 罷
藤	草 滕	艸 滕	艹 滕
藥	草 樂	艸 樂	艹 樂
藦	草 摩	艸 摩	艹 摩
藧	草 緩	艸 緩	艹 緩
藨	草 麃	艸 麃	艹 麃
藩	草 潘	艸 潘	艹 潘
藪	草 數	艸 數	艹 數
藫	水 蕈	氵 蕈
藬	草 隤	艸 隤	艹 隤
藭	草 窮	艸 窮	艹 窮
藮	草 樵	艸 樵	艹 樵
藯	草 慰	艸 慰	艹 慰
藰	草 劉	艸 劉	艹 劉
藱	草 廆	艸 廆	艹 廆
藳	草 稾	艸 稾	艹 稾	蒿 禾
藴	草 縕	艸 縕	艹 縕
藶	草 歷	艸 歷	艹 歷
藷	草 諸	艸 諸	艹 諸
藸	草 豬	艸 豬	艹 豬
藹	草 謁	艸 謁	艹 謁
藺	草 閵	艸 閵	艹 閵
藻	草 澡	艸 澡	艹 澡
藼	草 憲	艸 憲	艹 憲
藽	草 親	艸 親	艹 親
藾	草 賴	艸 賴	艹 賴
藿	草 霍	艸 霍	艹 霍
蘀	草 擇	艸 擇	艹 擇
蘁	草 噩	艸 噩	艹 噩
蘂	草 橤	艸 橤	艹 橤	蕊 木
蘃	草 歮 木	艸 歮 木	艹 歮 木
蘄	草 單 斤	艸 單 斤	艹 單 斤
蘅	草 衡	艸 衡	艹 衡
蘆	草 盧	艸 盧	艹 盧
蘇	草 穌	艸 穌	艹 穌
蘈	草 頹	艸 頹	艹 頹
蘉	草 网 冖 侵	艸 罒 冖 侵	艹 罒 冖 侵
蘊	草 縕	艸 縕	艹 縕
蘋	草 頻	艸 頻	艹 頻
蘌	草 禦	艸 禦	艹 禦
蘍	草 勳	艸 勳	艹 勳
蘎	草 雨 肥	艸 雨 肥	艹 雨 肥
蘐	草 諼	艸 諼	艹 諼
蘑	草 磨	艸 磨	艹 磨
蘓	草 禾 魚	艸 禾 魚	艹 禾 魚
蘔	草 穎	艸 穎	艹 穎
蘖	草 檗	艸 檗	艹 檗	薛 木
蘗	草 檗	艸 檗	艹 檗
蘘	草 襄	艸 襄	艹 襄
蘙	草 翳	艸 翳	艹 翳
蘚	草 鮮	艸 鮮	艹 鮮
蘛	草 甚 育	艸 甚 育	艹 甚 育
蘜	草 鞠	艸 鞠	艹 鞠
蘝	草 歛	艸 歛	艹 歛
蘞	草 斂	艸 斂	艹 斂
蘟	草 隱	艸 隱	艹 隱
蘠	草 牆	艸 牆	艹 牆
蘡	草 真 真 女	艸 真 真 女	艹 真 真 女
蘢	草 龍	艸 龍	艹 龍
蘣	草 黈	艸 黈	艹 黈
蘤	草 白 為	艸 白 為	艹 白 為
蘥	草 龠	艸 龠	艹 龠
蘦	草 霝	艸 霝	艹 霝
蘧	草 豦	艸 豦	艹 豦
蘨	草 爪 缶 系	艸 爫 缶 系	艹 爫 缶 系
蘩	草 繁	艸 繁	艹 繁
蘪	草 麋	艸 麋	艹 麋
蘫	草 濫	艸 濫	艹 濫
蘬	草 歸	艸 歸	艹 歸
蘭	草 闌	艸 闌	艹 闌
蘮	草 罽	艸 罽	艹 罽
蘯	草 盪	艸 盪	艹 盪	蕩 皿
蘱	草 類	艸 類	艹 類
蘲	草 壘	艸 壘	艹 壘
蘳	草 黊	艸 黊	艹 黊
蘴	草 豊	艸 豊	艹 豊
蘵	草 職	艸 職	艹 職
蘶	草 魏	艸 魏	艹 魏
蘷	草 夒	艸 夒	艹 夒
蘸	草 酉 隹 火	艸 酉 隹 灬	艹 酉 隹 灬
蘹	草 懷	艸 懷	艹 懷
蘺	草 離	艸 離	艹 離
蘻	草 繫	艸 繫	艹 繫
蘼	草 靡	艸 靡	艹 靡
蘽	草 櫐	艸 櫐	艹 櫐
蘾	草 壞	艸 壞	艹 壞
蘿	草 羅	艸 羅	艹 羅
虀	草 韲	艸 韲	艹 韲
虁	草 卝 夒	艸 卝 夒	艹 卝 夒
虂	草 露	艸 露	艹 露
虃	草 韱	艸 韱	艹 韱
虆	草 纍	艸 纍	艹 纍
虇	草 弓 雚	艸 弓 雚	艹 弓 雚
虈	草 吕 頁 吕	艸 吕 頁 吕	艹 吕 頁 吕	艹 口 口 頁 口 口	艹 囂
虉	草 鷊	艸 鷊	艹 鷊
虊	草 欒	艸 欒	艹 欒
虋	草 釁	艸 釁	艹 釁
虌	草 鼈	艸 鼈	艹 鼈	蔽 黽
虍	丨 一 厂 七
虎	虎 儿	虍 儿
虐	虎 匸 一	虍 匸 一
虒	厂 虎
虓	九 虎
虔	虎 文	虍 文
處	虎 夕 几	虍 夂 几
虖	虎 乎	虍 乎
虗	虎 丘	虍 丘
虘	虎 且	虍 且
虙	虎 必	虍 必
虛	虎 丱 一	虍 丱 一
虜	虎 男	虍 男
虝	虎 勿
虞	虎 吳	虍 吳
號	号 虎
虠	交 虎
虡	虎 丱 一 八	虍 丱 一 八
虢	寽 虎
虣	武 虎
虤	虎 虎
虥	虎 戔
虦	戔 虎
虧	虎 隹 亏	虍 隹 亏
虨	虎 彬	虍 彬	虎 林 彡	虍 林 彡
虩	小 日 小 虎
虪	虎 儵
虭	蟲 刀	虫 刀
虯	蟲 丩	虫 丩
虰	蟲 丁	虫 丁
虱	乁 一 蟲	乁 一 虫
虳	蟲 勺	虫 勺
虴	蟲 乇	虫 乇
虵	蟲 衆	虫 衆
虶	蟲 于	虫 于
虷	蟲 干	虫 干
虸	蟲 子	虫 子
虹	蟲 工	虫 工
虺	兀 蟲	兀 虫
虻	蟲 亡	虫 亡
虼	蟲 乞	虫 乞
蚄	蟲 方	虫 方
蚅	蟲 厄	虫 厄
蚆	蟲 巴	虫 巴
蚇	蟲 尺	虫 尺
蚈	蟲 开	虫 开
蚉	文 蟲	文 虫
蚊	蟲 文	虫 文
蚋	蟲 內	虫 內
蚌	蟲 丰	虫 丰
蚍	蟲 比	虫 比
蚎	蟲 日	虫 日
蚏	蟲 月	虫 月
蚐	蟲 勻	虫 勻
蚑	蟲 支	虫 支
蚒	蟲 丹	虫 丹
蚓	蟲 引	虫 引
蚔	蟲 氏	虫 氏
蚖	蟲 元	虫 元
蚗	蟲 夬	虫 夬
蚘	蟲 尤	虫 尤
蚙	蟲 今	虫 今
蚚	蟲 斤	虫 斤
蚛	蟲 中	虫 中
蚜	蟲 牙	虫 牙
蚝	蟲 毛	虫 毛
蚞	蟲 木	虫 木
蚟	蟲 王	虫 王
蚠	分 蟲	分 虫
蚡	蟲 分	虫 分
蚢	蟲 亢	虫 亢
蚣	蟲 公	虫 公
蚤	叉 丶 蟲	叉 丶 虫
蚥	蟲 父	虫 父
蚦	蟲 冄	虫 冄
蚧	蟲 介	虫 介
蚨	蟲 夫	虫 夫
蚩	屮 一 蟲	屮 一 虫	山 一 虫
蚪	蟲 斗	虫 斗
蚫	蟲 包	虫 包
蚭	蟲 尼	虫 尼
蚮	蟲 代	虫 代
蚯	蟲 丘	虫 丘
蚰	蟲 由	虫 由
蚱	蟲 乍	虫 乍
蚲	蟲 平	虫 平
蚳	蟲 氐	虫 氐
蚴	蟲 幼	虫 幼
蚵	蟲 可	虫 可
蚶	蟲 甘	虫 甘
蚷	蟲 巨	虫 巨
蚸	蟲 斥	虫 斥
蚹	蟲 付	虫 付
蚺	蟲 冉	虫 冉
蚻	札 蟲	札 虫
蚼	蟲 句	虫 句
蚽	蟲 丕	虫 丕
蚾	蟲 皮	虫 皮
蚿	蟲 玄	虫 玄
蛀	蟲 主	虫 主
蛁	蟲 召	虫 召
蛂	蟲 犮	虫 犮
蛃	蟲 丙	虫 丙
蛄	蟲 古	虫 古
蛅	蟲 占	虫 占
蛆	蟲 且	虫 且
蛇	蟲 它	虫 它
蛈	蟲 失	虫 失
蛉	蟲 令	虫 令
蛋	疋 蟲	疋 虫
蛌	蟲 瓜	虫 瓜
蛍	小 冖 蟲	小 冖 虫
蛐	蟲 曲	虫 曲
蛑	蟲 牟	虫 牟
蛒	蟲 各	虫 各
蛓	十 戈 蟲	土 戈 蟲	十 戈 虫	土 戈 虫	𢦏 蟲	𢦏 虫
蛔	蟲 回	虫 回
蛕	蟲 有	虫 有
蛖	蟲 尨	虫 尨
蛗	戶 乛 一 蟲	戶 乛 一 虫	户 乛 一 蟲	户 乛 一 虫
蛘	蟲 羊	虫 羊
蛙	蟲 圭	虫 圭
蛚	蟲 列	虫 列
蛛	蟲 朱	虫 朱
蛜	蟲 伊	虫 伊
蛝	蟲 艮	虫 艮
蛞	蟲 舌	虫 舌
蛟	蟲 交	虫 交
蛠	蟲 劦	虫 劦
蛡	蟲 羽	虫 羽
蛢	蟲 并	虫 并	蟲 幷	虫 幷
蛣	蟲 吉	虫 吉
蛤	蟲 合	虫 合
蛥	蟲 多	虫 多
蛦	蟲 夷	虫 夷
蛨	蟲 百	虫 百
蛩	巩 蟲	巩 虫
蛪	丰 刀 蟲	丰 刀 虫
蛫	蟲 危	虫 危
蛬	共 蟲	共 虫
蛭	蟲 至	虫 至
蛵	蟲 巠	虫 巠
蛶	蟲 寽	虫 寽
蛷	蟲 求	虫 求
蛸	蟲 肖	虫 肖
蛹	蟲 甬	虫 甬
蛺	蟲 夾	虫 夾
蛻	蟲 兌	虫 兌
蛼	蟲 車	虫 車
蛽	蟲 貝	虫 貝
蛾	蟲 我	虫 我
蛿	蟲 含	虫 含
蜀	网 勹 蟲	罒 勹 蟲	罒 勹 虫
蜁	蟲 丿 一 疋	虫 丿 一 疋
蜂	蟲 夆	虫 夆
蜃	辰 蟲	辰 虫
蜄	蟲 辰	虫 辰
蜅	蟲 甫	虫 甫
蜆	蟲 見	虫 見
蜇	折 蟲	折 虫
蜈	蟲 吳	虫 吳
蜉	蟲 孚	虫 孚
蜊	蟲 利	虫 利
蜋	蟲 良	虫 良
蜌	蟲 比 土	虫 比 土
蜍	蟲 余	虫 余
蜎	蟲 肙	虫 肙
蜏	蟲 秀	虫 秀
蜑	延 蟲	延 虫
蜒	蟲 延	虫 延
蜓	蟲 廷	虫 廷
蜔	蟲 甸	虫 甸
蜖	蟲 囬	虫 囬
蜘	蟲 知	虫 知
蜙	蟲 松	虫 松
蜚	蟲 非	虫 非
蜛	蟲 居	虫 居
蜜	宀 必 蟲	宀 必 虫	宓 蟲	宓 虫
蜝	其 蟲	其 虫
蜞	蟲 其	虫 其
蜟	蟲 育	虫 育
蜠	蟲 囷	虫 囷
蜢	蟲 孟	虫 孟
蜣	蟲 羌	虫 羌
蜤	析 蟲	析 虫
蜥	蟲 析	虫 析
蜦	蟲 侖	虫 侖
蜧	蟲 戾	虫 戾
蜨	蟲 疌	虫 疌
蜩	蟲 周	虫 周
蜪	蟲 匋	虫 匋
蜫	蟲 昆	虫 昆
蜬	蟲 函	虫 函
蜭	蟲 臽	虫 臽
蜮	蟲 或	虫 或
蜯	蟲 奉	虫 奉
蜰	肥 蟲	肥 虫
蜱	蟲 卑	虫 卑
蜲	蟲 委	虫 委
蜳	蟲 享	虫 享
蜴	蟲 易	虫 易
蜵	蟲 片 一 爿	虫 片 一 爿
蜶	蟲 卒	虫 卒
蜷	蟲 卷	虫 卷
蜸	臣 又 蟲	臣 又 虫
蜹	蟲 芮	虫 芮
蜺	蟲 兒	虫 兒
蜻	蟲 青	虫 青
蜼	蟲 隹	虫 隹
蜽	蟲 兩	虫 兩
蜾	蟲 果	虫 果
蜿	蟲 宛	虫 宛
蝀	蟲 東	虫 東
蝁	亞 蟲	亞 虫
蝂	蟲 版	虫 版
蝃	蟲 叕	虫 叕
蝄	蟲 罔	虫 罔
蝅	天 天 蟲	天 天 虫
蝆	蟲 芈	虫 芈
蝋	蟲 鼡	虫 鼡
蝌	蟲 科	虫 科
蝍	蟲 即	虫 即
蝎	蟲 曷	虫 曷
蝏	蟲 亭	虫 亭
蝐	蟲 冒	虫 冒
蝑	蟲 胥	虫 胥
蝒	蟲 面	虫 面
蝓	蟲 俞	虫 俞
蝔	蟲 皆	虫 皆
蝕	食 蟲	飠 虫	食 虫
蝖	蟲 宣	虫 宣
蝗	蟲 皇	虫 皇
蝘	蟲 匽	虫 匽
蝙	蟲 扁	虫 扁
蝚	蟲 柔	虫 柔
蝛	蟲 威	虫 威
蝜	蟲 負	虫 負
蝝	蟲 彖	虫 彖
蝞	蟲 眉	虫 眉
蝟	蟲 胃	虫 胃
蝠	蟲 畐	虫 畐
蝡	蟲 耎	虫 耎
蝢	蟲 頁	虫 頁
蝣	蟲 斿	虫 斿
蝤	蟲 酋	虫 酋
蝥	敄 蟲	敄 虫
蝦	蟲 叚	虫 叚
蝧	蟲 英	虫 英
蝨	卂 蟲 蟲	卂 虫 虫
蝩	蟲 重	虫 重
蝪	蟲 昜	虫 昜
蝫	蟲 者	虫 者
蝬	蟲 凶 八 夕	虫 凶 八 夂
蝭	蟲 是	虫 是
蝮	蟲 复	虫 复
蝯	蟲 爰	虫 爰
蝰	蟲 奎	虫 奎
蝱	亡 蟲 蟲	亡 虫 虫
蝲	蟲 剌	虫 剌
蝳	蟲 毒	虫 毒
蝴	蟲 胡	虫 胡
蝵	秋 蟲	秋 虫
蝶	蟲 枼	虫 枼
蝷	蟲 广 屰	虫 广 屰
蝸	蟲 咼	虫 咼
蝹	蟲 昷	虫 昷
蝺	蟲 禹	虫 禹
蝻	蟲 南	虫 南
蝽	蟲 春	虫 春
蝿	蟲 曰 电	蟲 田 电	虫 曰 电	虫 田 电
螂	蟲 郎	虫 郎
螃	蟲 旁	虫 旁
螄	蟲 師	虫 師
螅	蟲 息	虫 息
螆	蟲 茲	虫 茲
螇	蟲 奚	虫 奚
螈	蟲 原	虫 原
螉	蟲 翁	虫 翁
螊	蟲 兼	虫 兼
螋	蟲 叟	虫 叟
螌	般 蟲	般 虫
融	鬲 蟲	鬲 虫
螎	蟲 鬲	虫 鬲
螏	蟲 疾	虫 疾
螐	蟲 烏	虫 烏
螑	蟲 臭	虫 臭
螒	十 日 十 人 蟲	十 日 十 人 虫
螓	蟲 秦	虫 秦
螔	蟲 虒	虫 虒
螕	蟲 囟 比	虫 囟 比
螖	蟲 骨	虫 骨
螗	蟲 唐	虫 唐
螘	蟲 豈	虫 豈
螙	木 蟲 蟲	木 虫 虫
螚	能 蟲	能 虫
螛	蟲 害	虫 害
螜	士 冖 殳 蟲	士 冖 殳 虫
螝	蟲 鬼	虫 鬼
螞	蟲 馬	虫 馬
螟	蟲 冥	虫 冥
螠	蟲 益	虫 益
螡	文 蟲 蟲	文 虫 虫
螢	火 火 冖 蟲	火 火 冖 虫	𤇾 蟲	𤇾 虫
螣	丷 夫 蟲	丷 夫 虫	𠔉 蟲
螤	蚉 臾
螥	蟲 倉	虫 倉
螪	蟲 商	虫 商
螫	赦 蟲	赦 虫
螬	蟲 曹	虫 曹
螭	蟲 离	虫 离
螮	蟲 帶	虫 帶
螯	敖 蟲	敖 虫
螰	蟲 鹿	虫 鹿
螱	尉 蟲	尉 虫
螲	蟲 窒	虫 窒
螳	蟲 堂	虫 堂
螴	陳 蟲	陳 虫
螵	蟲 票	虫 票
螶	巨 蟲 蟲	巨 虫 虫
螷	庳 蟲	庳 虫
螸	欲 蟲	欲 虫
螹	蟲 斬	虫 斬
螺	蟲 累	虫 累
螻	蟲 婁	虫 婁
螼	蟲 堇	虫 堇
螽	冬 蟲 蟲	冬 虫 虫
螾	蟲 寅	虫 寅
螿	將 蟲	將 虫
蟀	蟲 率	虫 率
蟁	民 蟲 蟲	民 虫 虫
蟂	蟲 梟	虫 梟
蟃	蟲 曼	虫 曼
蟄	執 蟲	執 虫
蟅	蟲 庶	虫 庶
蟆	蟲 莫	虫 莫
蟇	莫 蟲	莫 虫
蟈	蟲 國	虫 國
蟉	蟲 翏	虫 翏
蟊	矛 蟲 蟲	矛 虫 虫
蟋	蟲 悉	虫 悉
蟌	蟲 悤	虫 悤
蟍	蟲 梨	虫 梨
蟎	蟲 廿 冂 丨 入 入	虫 廿 冂 丨 入 入	蟲 㒼	虫 㒼
蟑	蟲 章	虫 章
蟒	蟲 莽	虫 莽
蟓	蟲 象	虫 象
蟔	蟲 黑	虫 黑
蟕	蟲 觜	虫 觜
蟖	蟲 斯	虫 斯
蟗	一 口 丨 冂 出 蟲	一 口 丨 冂 出 虫
蟘	蟲 貸	虫 貸
蟙	蟲 戠	虫 戠
蟚	彭 蟲	彭 虫
蟛	蟲 彭	虫 彭
蟜	蟲 喬	虫 喬
蟝	蟲 渠	虫 渠
蟞	敝 蟲	敝 虫
蟟	蟲 尞	虫 尞
蟠	蟲 番	虫 番
蟡	蟲 為	虫 為
蟢	蟲 喜	虫 喜
蟣	蟲 幾	虫 幾
蟤	蟲 巽	虫 巽
蟥	蟲 黃	虫 黃
蟦	蟲 賁	虫 賁
蟧	蟲 勞	虫 勞
蟨	厥 蟲	厥 虫
蟩	蟲 厥	虫 厥
蟪	蟲 惠	虫 惠
蟫	蟲 覃	虫 覃
蟬	蟲 單	虫 單
蟭	蟲 焦	虫 焦
蟮	蟲 善	虫 善
蟯	蟲 堯	虫 堯
蟰	蟲 肅	虫 肅
蟱	蟲 無	虫 無
蟲	虫 虫 虫
蟳	蟲 尋	虫 尋
蟴	斯 蟲	斯 虫
蟶	蟲 聖	虫 聖
蟷	蟲 當	虫 當
蟸	豕 蟲 蟲	豕 虫 虫
蟹	解 蟲	解 虫
蟺	蟲 亶	虫 亶
蟻	虫 義	蟲 義
蟼	敬 蟲	敬 虫
蟽	蟲 達	虫 達
蟾	蟲 詹	虫 詹
蟿	車 凵 殳 蟲	車 凵 殳 虫
蠀	蟲 資	虫 資
蠁	鄉 蟲	鄉 虫
蠂	蟲 葉	虫 葉
蠃	亡 口 月 蟲 凡	亡 口 月 虫 凡
蠄	蟲 禽	虫 禽
蠅	蟲 黽	虫 黽
蠆	萬 蟲	萬 虫
蠇	蟲 萬	虫 萬
蠈	賊 蟲	賊 虫
蠉	蟲 睘	虫 睘
蠊	蟲 廉	虫 廉
蠋	蟲 蜀	虫 蜀
蠌	蟲 睪	虫 睪
蠍	蟲 歇	虫 歇
蠎	蟲 莾	虫 莾
蠏	蟲 解	虫 解
蠐	蟲 齊	虫 齊
蠑	蟲 榮	虫 榮
蠒	爾 蟲	爾 虫
蠓	蟲 蒙	虫 蒙
蠔	蟲 豪	虫 豪
蠕	蟲 需	虫 需
蠖	蟲 蒦	虫 蒦
蠗	蟲 翟	虫 翟
蠘	蟲 截	虫 截
蠙	蟲 賓	虫 賓
蠚	若 蟲 蟲	若 虫 虫
蠛	蟲 蔑	虫 蔑
蠜	棥 大 蟲	棥 大 虫	木 爻 木 大 蟲	木 爻 木 大 虫
蠝	蟲 畾	虫 畾
蠟	蟲 巤	虫 巤
蠠	面 蟲 蟲	面 虫 虫
蠡	彖 蟲 蟲	彖 虫 虫
蠢	春 蟲 蟲	春 虫 虫
蠣	蟲 厲	虫 厲
蠤	酋 蟲 蟲	酋 虫 虫
蠥	辥 蟲	辥 虫
蠦	蟲 盧	虫 盧
蠧	士 冖 石 蟲 蟲	士 冖 石 虫 虫
蠨	蟲 蕭	虫 蕭
蠩	蟲 諸	虫 諸
蠪	龍 蟲	龍 虫
蠫	豸 刀 蟲 蟲	豸 刂 虫 虫
蠬	蟲 龍	虫 龍
蠭	逢 蟲 蟲	逢 虫 虫
蠮	蟲 翳	虫 翳
蠯	广 卑 蟲 蟲	广 卑 虫 虫
蠰	蟲 襄	虫 襄
蠱	蟲 皿	虫 皿
蠲	益 蜀
蠳	蟲 嬰	虫 嬰
蠵	蟲 巂	虫 巂
蠶	旡 旡 日 蟲 蟲	旡 旡 日 虫 虫	朁 蟲 蟲	朁 虫 虫
蠷	蟲 瞿	虫 瞿
蠸	蟲 雚	虫 雚
蠹	一 中 冖 石 蟲 蟲	一 中 冖 石 虫 虫
蠺	天 天 日 蟲 蟲	天 天 日 虫 虫
蠻	絲 言 蟲	糸 言 糸 蟲	絲 言 虫	䜌 蟲	䜌 虫
蠼	蟲 瞿 又	虫 瞿 又
蠽	雀 戈 蟲 蟲	雀 戈 虫 虫
蠾	蟲 屬	虫 屬
蠿	幺 幺 一 丨 一 幺 幺 蟲 蟲	幺 幺 一 丨 一 幺 幺 虫 虫
血	丶 皿	丿 皿
衁	亡 血
衂	血 刄
衃	血 不
衄	血 丑
衆	血 乑
衇	血 厂 氏	血 𠂢
衈	血 耳
衉	血 各
衊	血 蔑
衋	聿 百 百 血
行	彳 亍
衍	行 水	行 氵
衎	行 干
衏	行 元
衑	行 令
衒	行 玄
術	行 木 丶
衕	行 同
衖	行 共
街	行 圭	行 土 土
衘	行 午 止
衙	行 吾
衚	行 胡
衛	行 韋
衜	行 首
衝	行 重
衞	行 ㇆ 丨 一 口 币	行 ㇆ 丨 一 口 帀
衟	行 巛 首
衠	行 真
衡	行 刀 田 大
衢	行 瞿
衣	丶 一 
衤	丶 乙 丨 丶 丶
衦	衣 干	衤 干
衧	衣 于	衤 于
表	丰 
衩	衣 叉	衤 叉
衪	衣 也	衤 也
衫	衣 彡	衤 彡
衭	衣 夫	衤 夫
衯	衣 分	衤 分
衰	衣 中 一
衲	衣 內	衤 內
衳	衣 公	衤 公
衴	衣 冘	衤 冘
衵	衣 日	衤 日
衶	衣 中	衤 中
衷	衣 中	一 中 衣
衸	衣 介	衤 介
衹	衣 氏	衤 氏
衺	衣 牙
衻	衣 冄	衤 冄
衼	衣 支	衤 支
衽	衣 壬	衤 壬
衾	今 衣
衿	衣 今	衤 今
袀	衣 勻	衤 勻
袁	土 口 衣
袂	衣 夬	衤 夬
袃	切 衣
袇	衣 丹	衤 丹
袈	加 衣
袉	衣 它	衤 它
袊	衣 令	衤 令
袋	代 衣
袌	衣 包
袍	衣 包	衤 包
袎	衣 幼	衤 幼
袏	衣 左	衤 左
袐	衣 必	衤 必
袑	衣 召	衤 召
袒	衣 旦	衤 旦
袓	衣 且	衤 且
袔	衣 可	衤 可
袕	衣 穴	衤 穴
袖	衣 由	衤 由
袗	衣 人 彡	衤 人 彡
袘	衣 丿 一 也	衤 丿 一 也
袙	衣 白	衤 白
袚	衣 犮	衤 犮
袛	衣 氐	衤 氐
袝	衣 付	衤 付
袞	衣 八 口
袟	衣 失	衤 失
袠	衣 失
袡	衣 冉	衤 冉
袢	衣 半	衤 半
袣	衣 世	衤 世
袤	衣 矛
袦	衣 出	衤 出
袧	衣 句	衤 句
袨	衣 玄	衤 玄
袩	衣 占	衤 占
袪	衣 去	衤 去
被	衣 皮	衤 皮
袬	衣 台
袱	衣 伏	衤 伏
袲	衣 多
袳	衣 多	衤 多
袴	衣 夸	衤 夸
袵	衣 任	衤 任
袶	衣 夅	衤 夅
袷	衣 合	衤 合
袸	衣 存	衤 存
袹	衣 百	衤 百
袺	衣 吉	衤 吉
袻	衣 而	衤 而
袼	衣 各	衤 各
袽	衣 如	衤 如
袾	衣 朱	衤 朱
袿	衣 圭	衤 圭
裀	衣 因	衤 因
裁	十 戈 衣	土 戈 衣	𢦏 衣
裂	列 衣
裉	衣 艮	衤 艮
裊	户 一 一 ㇆ 衣
裋	衣 豆	衤 豆
裌	衣 夾	衤 夾
裍	衣 困	衤 困
裎	衣 呈	衤 呈
裏	衣 里
裐	衣 肙	衤 肙
裑	衣 身	衤 身
裒	衣 臼
裓	衣 戒	衤 戒
裔	衣 冏
裕	衣 谷	衤 谷
裖	衣 辰	衤 辰
裗	衣 亠 厶 川	衤 亠 厶 川	衣 巟	衤 巟	衣 㐬
裘	衣 求
裙	衣 君	衤 君
裚	折 衣
裛	衣 邑
補	衣 甫	衤 甫
裝	壯 衣
裞	衣 兌	衤 兌
裟	沙 衣
裠	君 衣
裡	衣 里	衤 里
裦	衣 厂 二 矛
裧	衣 炎	衤 炎
裨	衣 卑	衤 卑
裩	衣 昆	衤 昆
裪	衣 匋	衤 匋
裫	衣 片 一 爿	衤 片 一 爿
裬	衣 夌	衤 夌
裭	衣 虎	衤 虎
裮	衣 昌	衤 昌
裯	衣 周	衤 周
裰	衣 叕	衤 叕
裱	衣 表	衤 表
裲	衣 兩	衤 兩
裳	尚 衣
裴	非 衣
裵	衣 非
裶	衣 非	衤 非
裷	衣 卷	衤 卷
裸	衣 果	衤 果
裹	衣 果
裺	衣 奄	衤 奄
裻	叔 衣
裼	衣 易	衤 易
製	制 衣
裾	衣 居	衤 居
裿	衣 奇	衤 奇
褀	衣 其	衤 其
褁	果 
褂	衣 卦	衤 卦
褃	衣 肯	衤 肯
褅	衣 帝	衤 帝
褆	衣 是	衤 是
複	衣 复	衤 复
褈	衣 重	衤 重
褉	衣 契	衤 契
褊	衣 扁	衤 扁
褋	衣 枼	衤 枼
褌	衣 軍	衤 軍
褍	衣 耑	衤 耑
褎	衣 厂 二 禾
褏	衣 厂 二 由
褐	衣 曷	衤 曷
褑	衣 爰	衤 爰
褒	保 衣	亠 保 衣
褓	衣 保	衤 保
褔	衣 畐	衤 畐
褕	衣 俞	衤 俞
褖	衣 彖	衤 彖
褗	衣 匽	衤 匽
褘	衣 韋	衤 韋
褙	衣 背	衤 背
褚	衣 者	衤 者
褞	衣 昷	衤 昷
褟	衣 日 羽	衤 日 羽
褠	衣 冓	衤 冓
褡	衣 荅	衤 荅
褢	衣 鬼
褣	衣 容	衤 容
褤	衣 袁	衤 袁
褥	衣 辱	衤 辱
褦	衣 能	衤 能
褧	耿 衣
褨	衣 差	衤 差
褩	般 衣
褪	衣 退	衤 退
褫	衣 虒	衤 虒
褬	衣 桑	衤 桑
褭	衣 馬
褮	火 火 冖 衣	𤇾 衣
褯	衣 席	衤 席
褰	宀 井 大 衣
褱	衣 目 二 丨 二	衣 网 二 丨 二	衣 罒 二 丨 二	衣 目 丨 丷 八
褲	衣 庫	衤 庫
褳	衣 連	衤 連
褵	衣 离	衤 离
褶	衣 習	衤 習
褷	衣 徙	衤 徙
褸	衣 婁	衤 婁
褹	衣 埶	衤 埶
褺	執 衣
褻	衣 埶	衣 執
褼	衣 西 大 己	衤 西 大 己	衣 覀 大 己	衤 覀 大 己
褽	尉 衣
褾	衣 票	衤 票
褿	衣 曹	衤 曹
襀	衣 責	衤 責
襁	衣 強	衤 強
襂	衣 參	衤 參
襃	衣 厂 二 呆
襄	口 口 井 一 衣
襆	衣 菐	衤 菐
襇	衣 間	衤 間
襈	衣 巽	衤 巽
襉	衣 閒	衤 閒
襊	衣 最	衤 最
襋	衣 棘	衤 棘
襌	衣 單	衤 單
襍	衣 集	衤 集
襎	衣 番	衤 番
襏	衣 發	衤 發
襐	衣 象	衤 象
襑	衣 尋	衤 尋
襒	衣 敝	衤 敝
襓	衣 堯	衤 堯
襔	衣 廿 冂 丨 入 入	衤 廿 冂 丨 入 入	衣 㒼	衤 㒼
襖	衣 奧	衤 奧
襗	衣 睪	衤 睪
襘	衣 會	衤 會
襙	衣 喿	衤 喿
襚	衣 遂	衤 遂
襛	衣 農	衤 農
襜	衣 詹	衤 詹
襝	衣 僉	衤 僉
襞	辟 衣
襟	衣 禁	衤 禁
襠	衣 當	衤 當
襡	衣 蜀	衤 蜀
襢	衣 亶	衤 亶
襣	衣 鼻	衤 鼻
襤	衣 監	衤 監
襥	衣 僕	衤 僕
襦	衣 需	衤 需
襧	衣 爾	衤 爾
襩	衣 賣	衤 賣
襪	衣 蔑	衤 蔑
襫	衣 奭	衤 奭
襬	衣 罷	衤 罷
襭	衣 頡	衤 頡
襮	衣 暴	衤 暴
襯	衣 親	衤 親
襰	衣 賴	衤 賴
襱	衣 龍	衤 龍
襲	龍 衣
襳	衣 韱	衤 韱
襴	衣 闌	衤 闌
襵	衣 聶	衤 聶
襶	衣 戴	衤 戴
襸	衣 贊	衤 贊
襹	衣 麗	衤 麗
襺	衣 繭	衤 繭
襻	衣 攀	衤 攀
襼	衣 藝	衤 藝
襾	一 凵 冂
西	一 口 儿	一 囗 儿	一 四
覀	一 丨 丨 口
要	西 女	襾 女	覀 女
覂	西 乏	覀 乏
覃	西 早	襾 早	覀 早
覅	要 勿
覆	西 復	覀 復
覇	西 革 月	覀 革 月
覈	西 敫	襾 敫
覉	西 革 奇	覀 革 奇
覊	西 革 馬	襾 革 馬	覀 革 馬
見	目 儿
覌	又 見
覍	小 見
覎	見 子
規	夫 見
覐	見 爻
覑	片 見
覒	毛 見
覓	爪 見	爫 見
覔	不 見
覕	必 見
視	示 見	礻 見
覗	司 見
覘	占 見
覙	尔 見
覚	小 冖 見
覛	厂 氏 見	𠂢 見
覜	兆 見
覝	干 火 見
覞	見 見
覟	志 見
覠	君 見
覡	巫 見
覢	炎 見
覣	委 見
覤	虎 見
覥	典 見
覦	俞 見
覧	臣 丿 一 丶 見	臣 丿 一 丶 見
覨	咢 見
覩	者 見
親	亲 見	立 木 見
覫	旁 見
覬	豈 見
覭	冥 見
覮	火 火 冖 見	𤇾 見
覯	冓 見
覰	虘 見
覱	斬 見
覲	堇 見
観	丿 二 隹 見
覴	登 見
覵	閒 見
覶	爪 龴 冂 厶 又 見	爫 龴 冂 厶 又 見
覷	虛 見
覸	間 見
覹	見 微
覺	臼 爻 冖 見	𦥯 見
覻	虎 豆 見	虍 豆 見
覼	爾 見
覽	臣 丿 一 丶 网 見	臣 丿 一 丶 罒 見
覾	審 見
覿	賣 見
觀	雚 見
觓	角 丩
觔	角 力
觕	牛 角	牜 角
觖	角 夬
觗	角 氏
觘	角 少
觙	角 及
觚	角 瓜
觛	角 旦
觜	此 角
觝	角 氐
觟	角 圭
觠	丷 夫 角	𠔉 角
觡	角 各
觢	丰 刀 角
解	角 刀 牛
觤	角 危
觥	角 光
觧	角 羊
觨	角 汞
觩	角 求
觪	角 辛
觫	角 束
觬	角 兒
觭	角 奇
觮	角 录
觰	角 者
觱	咸 角
觲	角 羊 牛
觳	士 冖 角 殳
觴	角 丿 一 昜
觵	角 黃
觶	角 單
觷	臼 爻 冖 角	𦥯 角
觸	角 蜀
觹	角 雋
觺	疑 角
觻	角 樂
觼	角 夐
觽	角 嶲
觾	角 燕
觿	角 巂
言	二 二 口	丶 一 二 口
訁	丶 一 二 口
訂	言 丁	訁 丁
訃	言 卜	訁 卜
訄	九 言
訅	言 九	訁 九
訆	言 丩	訁 丩
訇	勹 言
計	言 十	訁 十
訉	言 凡	訁 凡
訊	言 卂	訁 卂
訋	言 勺	訁 勺
訌	言 工	訁 工
訍	言 叉	訁 叉
討	言 寸	訁 寸
訏	言 于	訁 于
訐	言 干	訁 干
訑	言 也	訁 也
訒	言 刃	訁 刃
訓	言 川	訁 川
訔	山 言
訕	言 山	訁 山
訖	言 乞	訁 乞
託	言 乇	訁 乇
託	言 乇	訁 乇
記	言 己	訁 己
訙	言 丸	訁 丸
訛	言 化	訁 化
訜	言 分	訁 分
訝	言 牙	訁 牙
訞	言 夭	訁 夭
訟	言 公	訁 公
訠	言 引	訁 引
訡	言 今	訁 今
訢	言 斤	訁 斤
訣	言 夬	訁 夬
訤	言 爻	訁 爻
訥	言 內	訁 內
訦	言 冘	訁 冘
訧	言 尤	訁 尤
訨	言 止	訁 止
訩	言 凶	訁 凶
訪	言 方	訁 方
訫	言 心	訁 心
訬	言 少	訁 少
設	言 殳	訁 殳
訮	言 开	訁 开
訯	言 及	訁 及
訰	言 屯	訁 屯
許	言 午	訁 午
訲	言 中	訁 中
訳	言 尺	訁 尺
訴	言 斥	訁 斥
訵	言 四	訁 四
訶	言 可	訁 可
訷	言 申	訁 申
訸	言 禾	訁 禾
訹	言 朮	訁 朮
診	言 人 彡	訁 人 彡
註	言 主	訁 主
証	言 正	訁 正
訽	言 句	訁 句
訾	此 言
訿	言 此	訁 此
詀	言 占	訁 占
詁	言 古	訁 古
詂	言 付	訁 付
詃	言 玄	訁 玄
詄	言 失	訁 失
詅	言 令	訁 令
詆	言 氐	訁 氐	言 氏 丶
詇	言 央	訁 央
詈	目 言	罒 言
詉	言 奴	訁 奴
詊	言 半	訁 半
詋	言 兄	訁 兄
詌	言 甘	訁 甘
詍	言 世	訁 世
詎	言 巨	訁 巨
詏	言 幼	訁 幼
詐	言 乍	訁 乍
詑	言 它	訁 它
詒	言 台	訁 台
詓	言 去	訁 去
詔	言 召	訁 召
評	言 平	訁 平
詖	言 皮	訁 皮
詗	言 冋	訁 冋
詘	言 出	訁 出
詙	言 犮	訁 犮
詚	言 旦	訁 旦
詛	言 且	訁 且
詜	言 山 又	訁 山 又	訁 屮 又
詝	言 宁	訁 宁
詞	言 司	訁 司
詠	言 永	訁 永
詡	言 羽	訁 羽
詢	言 旬	訁 旬
詣	言 旨	訁 旨
詤	言 亾 川	訁 亾 川
詥	言 合	訁 合
試	言 式	訁 式
詧	夗 言
詨	言 交	訁 交
詩	言 寺	訁 寺
詪	言 艮	訁 艮
詫	言 宅	訁 宅
詬	言 后	訁 后
詭	言 危	訁 危
詮	言 全	訁 全
詯	言 自	訁 自
詰	言 吉	訁 吉
話	言 舌	訁 舌
該	言 亥	訁 亥
詳	言 羊	訁 羊
詴	言 有	訁 有
詵	言 先	訁 先
詶	言 州	訁 州
詷	言 同	訁 同
詸	言 米	訁 米
詹	刀 厂 儿 言
詺	言 名	訁 名
詻	言 各	訁 各
詼	言 灰	訁 灰
詽	言 幵	訁 幵
詾	言 匈	訁 匈
詿	言 圭	訁 圭
誀	言 耳	訁 耳
誁	言 并	訁 并	言 幷	訁 幷
誂	言 兆	訁 兆
誃	言 多	訁 多
誄	言 耒	訁 耒
誅	言 朱	訁 朱
誆	言 匡	訁 匡
誇	言 夸	訁 夸
誈	言 至	訁 至
誋	言 忌	訁 忌
誌	言 志	訁 志
認	言 忍	訁 忍
誎	言 束	訁 束
誏	言 良	訁 良
誐	言 我	訁 我
誑	言 狂	訁 狂
誒	言 矣	訁 矣
誓	折 言
誔	言 廷	訁 廷
誕	言 延	訁 延
誖	言 孛	訁 孛
誗	言 利	訁 利
誘	言 秀	訁 秀
誙	言 巠	訁 巠
誚	言 肖	訁 肖
誛	言 彐 冖 又	訁 彐 冖 又
誜	言 夋	訁 夋
誝	言 含	訁 含
語	言 吾	訁 吾
誟	言 孝	訁 孝
誠	言 成	訁 成
誡	言 戒	訁 戒
誢	言 見	訁 見
誣	言 巫	訁 巫
誤	言 吳	訁 吳
誥	言 告	訁 告
誦	言 甬	訁 甬
誧	言 甫	訁 甫
誨	言 每	訁 每
誩	言 言	訁 言
說	言 兌	訁 兌
誫	言 辰	訁 辰
説	言 兑	訁 兑
読	言 売	訁 売
誯	言 昌	訁 昌
誰	言 隹	訁 隹
課	言 果	訁 果
誳	言 屈	訁 屈
誴	言 宗	訁 宗
誵	言 肴	訁 肴
誶	言 卒	訁 卒
誷	言 罔	訁 罔
誸	言 弦	訁 弦
誹	言 非	訁 非
誺	言 來	訁 來
誻	言 沓	訁 沓
誼	言 宜	訁 宜
誽	言 兒	訁 兒
誾	門 言
調	言 周	訁 周
諀	言 卑	訁 卑
諁	言 叕	訁 叕
諂	言 臽	訁 臽
諃	言 林	訁 林
諄	言 享	訁 享
諅	其 言
諆	言 其	訁 其
談	言 炎	訁 炎
諈	言 垂	訁 垂
諉	言 委	訁 委
諊	言 匊	訁 匊
請	言 青	訁 青
諌	言 東	訁 東
諍	言 爭	訁 爭
諎	言 昔	訁 昔
諏	言 取	訁 取
諐	侃 言
諑	言 豖	訁 豖
諒	言 京	訁 京
諓	言 戔	訁 戔
諔	言 叔	訁 叔
諕	言 虎	訁 虎
論	言 侖	訁 侖
諗	言 念	訁 念
諘	言 表	訁 表
諙	言 昏	訁 昏
諚	言 定	訁 定
諛	言 臾	訁 臾
諜	言 枼	訁 枼	言 世 木
諝	言 胥	訁 胥
諞	言 扁	訁 扁
諟	言 是	訁 是
諠	言 宣	訁 宣
諡	言 兮 皿	訁 兮 皿
諢	言 軍	訁 軍
諣	言 咼	訁 咼
諤	言 咢	訁 咢
諥	言 重	訁 重
諦	言 帝	訁 帝
諧	言 皆	訁 皆
諨	言 畐	訁 畐
諩	言 並	訁 並
諪	言 亭	訁 亭
諫	言 柬	訁 柬
諬	禾 尤 言
諭	言 俞	訁 俞
諮	言 咨	訁 咨
諯	言 耑	訁 耑
諰	言 思	訁 思
諱	言 韋	訁 韋
諲	言 垔	訁 垔
諳	言 音	訁 音
諴	言 咸	訁 咸
諵	言 南	訁 南
諶	言 甚	訁 甚
諷	言 風	訁 風
諸	言 者	訁 者
諹	言 昜	訁 昜
諺	言 彦	訁 彦
諻	言 皇	訁 皇
諼	言 爰	訁 爰
諽	言 革	訁 革
諾	言 若	訁 若
諿	言 咠	訁 咠
謀	言 某	訁 某
謁	言 曷	訁 曷
謂	言 胃	訁 胃
謄	月 誊
謅	言 芻	訁 芻
謆	言 扇	訁 扇
謇	宀 井 大 言
謈	日 共 言
謊	言 荒	訁 荒
謋	言 桀	訁 桀
謌	言 哥	訁 哥
謍	火 火 冖 言	𤇾 言
謎	言 迷	訁 迷
謏	言 叟	訁 叟
謐	言 必 皿	訁 必 皿
謑	言 奚	訁 奚
謒	言 倉	訁 倉
謓	言 真	訁 真
謔	言 虐	訁 虐
謕	言 虒	訁 虒
謖	言 畟	訁 畟
謗	言 旁	訁 旁
謘	言 屖	訁 屖
謙	言 兼	訁 兼
謚	言 益	訁 益
講	言 冓	訁 冓
謜	言 原	訁 原
謝	言 射	訁 射
謞	言 高	訁 高
謟	言 舀	訁 舀
謠	言 月 缶	訁 月 缶	言 䍃	訁 䍃
謡	言 爪 击	訁 爫 击
謣	言 雩	訁 雩
謤	言 票	訁 票
謥	言 悤	訁 悤
謦	殸 言
謧	言 离	訁 离
謨	言 莫	訁 莫
謩	莫 言
謪	言 商	訁 商
謫	言 啇	訁 啇
謬	言 翏	訁 翏
謭	言 剪	訁 剪
謮	言 責	訁 責
謯	言 虘	訁 虘
謰	言 連	訁 連
謱	言 婁	訁 婁
謲	言 參	訁 參
謳	言 區	訁 區
謴	言 貫	訁 貫
謵	言 習	訁 習
謶	言 庶	訁 庶
謷	敖 言
謸	言 敖	訁 敖
謹	言 堇	訁 堇
謺	執 言
謻	言 移	訁 移
謼	言 虖	訁 虖
謽	強 言
謾	言 曼	訁 曼
謿	言 朝	訁 朝
譀	言 敢	訁 敢
譁	言 華	訁 華
譂	言 單	訁 單
譃	言 虛	訁 虛
譄	言 曾	訁 曾
譅	言 歰	訁 歰
譆	言 喜	訁 喜
譇	言 奢	訁 奢
譈	言 敦	訁 敦
證	言 登	訁 登
譊	言 堯	訁 堯
譋	言 閒	訁 閒
譌	言 爲	訁 爲	言 為	訁 為
譍	广 倠 言
譎	言 矞	訁 矞
譏	言 幾	訁 幾
譐	言 尊	訁 尊
譑	言 喬	訁 喬
譒	言 番	訁 番
譓	言 惠	訁 惠
譔	言 巽	訁 巽
譕	言 無	訁 無
譖	言 旡 旡 日	訁 旡 旡 日	言 朁	訁 朁
譗	言 答	訁 答
識	言 戠	訁 戠
譙	言 焦	訁 焦
譚	言 覃	訁 覃
譛	言 替	訁 替
譜	言 普	訁 普
譝	言 黽	訁 黽
譞	言 睘	訁 睘
譟	言 喿	訁 喿
譠	言 亶	訁 亶
譡	言 當	訁 當
譢	言 遂	訁 遂
譣	言 僉	訁 僉
譤	言 敫	訁 敫
譥	敫 言
警	敬 言
譧	言 廉	訁 廉
譨	言 農	訁 農
譩	言 意	訁 意
譪	言 葛	訁 葛
譫	言 詹	訁 詹
譬	辟 言
譭	言 毀	訁 毀
譮	言 會	訁 會
譯	言 睪	訁 睪
議	言 義	訁 義
譱	羊 言 言
譲	言 衣 八 井 一	訁 衣 八 井 一
譳	言 需	訁 需
譴	言 遣	訁 遣
譵	言 對	訁 對
譶	言 言 言
護	言 蒦	訁 蒦
譸	言 壽	訁 壽
譹	言 豪	訁 豪
譺	言 疑	訁 疑
譻	賏 言
譼	臣 丿 一 丶 网 言	臣 丿 一 丶 罒 言
譽	與 言
譾	言 翦	訁 翦
譿	言 慧	訁 慧
讀	言 賣	訁 賣
讁	言 適	訁 適
讂	言 夐	訁 夐
讃	言 賛	訁 賛
讄	言 畾	訁 畾
讅	言 審	訁 審
讆	衛 言
讇	言 閻	訁 閻
讈	言 歷	訁 歷
讉	言 遺	訁 遺
變	絲 言 夕	糸 言 糸 夕	絲 言 夂	䜌 夕	䜌 夂
讋	龍 言
讌	言 燕	訁 燕
讍	言 噩	訁 噩
讎	隹 言 隹	雔 言	隹 訁 隹
讏	衞 言
讐	雔 言	隹 隹 言
讑	言 龠	訁 龠
讒	言 毚	訁 毚
讓	言 襄	訁 襄
讔	言 隱	訁 隱
讕	言 闌	訁 闌
讖	言 韱	訁 韱
讗	言 巂	訁 巂
讘	言 聶	訁 聶
讙	言 雚	訁 雚
讚	言 贊	訁 贊
讛	言 藝	訁 藝
讜	言 黨	訁 黨
讝	言 嚴	訁 嚴
讞	言 獻	訁 獻
讟	言 賣 言
谷	八 人 口
谸	千 谷
谹	谷 厷
谺	谷 牙
谻	谷 卂 一
谼	谷 共
谽	谷 含
谾	谷 空
谿	奚 谷
豀	谷 奚
豁	害 谷
豂	谷 翏
豃	谷 敢
豄	谷 賣
豅	谷 龍
豆	一 口 丷 一
豇	豆 工
豈	山 豆
豉	豆 支
豊	曲 豆
豋	夗 豆
豌	豆 宛
豍	豆 卑
豎	臤 豆
豏	豆 兼
豐	山 丰 丰 豆
豑	豊 弟
豒	豐 弟
豓	豐 盇
豔	豐 盍
豕	一 丿 亅 丿 丿 丶 乀
豖	豕 丶
豗	兀 豕
豘	豕 屯
豙	亠 丷 豕	立 豕
豚	肉 豕	月 豕
豛	豕 殳
豜	豕 开
豝	豕 巴
豞	豕 句
豟	豕 戹
豠	豕 且
象	刀 口 丨 豕	刀 冖 丨 豕
豢	八 夫 豕	丷 夫 豕	𠔉 豕
豣	豕 幵
豤	豕 艮
豥	豕 亥
豦	虎 豕	虍 豕
豧	豕 甫
豨	豕 希
豩	豕 豕
豪	亠 口 冖 豕
豫	予 象
豬	豕 者
豭	豕 叚
豯	豕 奚
豰	士 冡 殳
豱	豕 昷
豲	豕 原
豳	山 豩	豕 山 豕
豴	豕 啇
豵	豕 從
豶	豕 賁
豷	豕 壹
豸	丿 丶 丶 丿 亅 丿 丿
豹	豸 勺
豺	豸 才
豻	豸 干
豼	豸 比
豽	豸 內
豾	豸 丕
豿	豸 句
貀	豸 出
貁	豸 穴
貂	豸 召
貃	豸 白
貄	豸 聿
貅	豸 休
貆	豸 亘
貇	豸 艮
貈	豸 舟
貉	豸 各
貊	豸 百
貋	豸 旱
貌	豸 白 儿
貍	豸 里	犭 里 狸
貎	豸 兒
貏	豸 卑
貐	豸 俞
貑	豸 叚
貒	豸 耑
貓	豕 苗
貔	豸 囟 比
貕	豸 奚
貖	豸 益
貗	豸 婁
貘	豸 莫
貙	豸 區
貚	豸 單
貛	豸 雚
貜	豸 矍
貝	目 八
貞	卜 貝
貟	厶 貝
負	刀 貝
財	貝 才
貢	工 貝
貣	弋 貝
貤	貝 也
貥	貝 亢
貦	貝 元
貧	分 貝
貨	化 貝
販	貝 反
貪	今 貝
貫	母 貝
責	丰 貝
貭	盾 八	厂 十 貝	厂 真
貮	一 弋 貝
貯	貝 宁
貰	世 貝
貱	貝 皮
貲	此 貝
貳	弋 二 貝
貴	中 一 貝
貵	厶 大 貝
貶	貝 乏
買	网 貝	罒 貝	罓 貝
貸	代 貝
貹	貝 生
貺	貝 兄
費	弗 貝
貼	貝 占
貽	貝 台
貾	貝 氐
貿	卯 貝
賀	加 貝
賁	十 十 十 貝
賂	貝 各
賃	任 貝
賄	貝 有
賅	貝 亥
賆	貝 并	貝 幷
資	次 貝
賈	西 貝	覀 貝	襾 貝
賉	貝 血
賊	貝 戎
賋	貝 交
賌	亥 貝
賍	貝 庄
賎	貝 一 戋
賏	貝 貝
賐	貝 夋
賑	貝 辰
賒	貝 佘
賓	宀 一 少 貝
賔	宀 眉 八
賕	貝 求
賖	貝 余
賗	貝 串
賘	貝 广 圡
賙	貝 周
賚	來 貝
賛	夫 夫 貝
賜	貝 易
賝	貝 罙
賞	尚 貝
賟	貝 典
賠	貝 咅
賡	庚 貝
賢	臤 貝
賣	士 買
賤	貝 戔
賥	貝 卒
賦	貝 武
賧	貝 炎
賨	宗 貝
賩	貝 宗
質	斤 斤 貝
賫	十 人 人 冖 貝
賬	貝 長
賭	貝 者
賮	聿 火 貝	聿 灬 貝
賯	貝 旬 子
賰	貝 春
賱	貝 軍
賲	保 貝
賳	貝 哉
賴	束 負
賵	貝 冒
賶	貝 倉
賷	十 口 口 冖 貝
賸	肉 丷 夫 貝	月 丷 夫 貝	肉 𠔉 貝	月 𠔉 貝
賹	貝 益
賺	貝 兼
賻	貝 専	貝 尃
購	貝 冓
賽	宀 井 大 貝
賿	貝 翏
贀	殹 貝
贁	貝 貝 攴	貝 貝 攵
贂	貝 參
贃	貝 患
贄	執 貝
贅	敖 貝
贆	貝 猋
贇	斌 貝
贈	貝 曽	貝 曾
贉	貝 覃
贊	先 先 貝
贋	厂 人 隹 貝	厂 亻 隹 貝	厂 倠 貝
贍	貝 詹
贎	貝 萬
贏	亡 口 月 貝 凡
贐	貝 盡
贑	章 貢
贒	臣 忠 貝
贓	貝 臧
贔	貝 貝 貝
贕	卵 賣
贖	貝 賣
贗	厂 人 鳥 貝	厂 亻 鳥 貝
贙	虎 虎 貝
贚	貝 龍
贛	立 早 夕 工 貝	立 早 夂 工 貝
贜	貝 藏
赤	土 丿 亅 八
赥	赤 欠
赦	赤 攴	赤 攵
赧	赤 卩 又
赨	赤 蟲	赤 虫
赩	赤 色
赫	赤 赤
赬	赤 貞
赭	赤 者
赮	赤 叚
赯	赤 唐
走	十 疋
赱	土 丷 乀
赲	走 力
赳	走 丩
赴	走 卜
起	走 己
赸	走 山
赹	走 勻
赺	走 今
赻	走 少
赼	走 欠
赽	走 夬
赾	走 斤
赿	走 氐
趀	走 丿 ㇉ 丨 丿	走 𠂔
趁	走 人 彡
趂	走 尔
趃	走 失
趄	走 且
超	走 召
趆	走 氐
趇	走 立
趈	走 占
趉	走 出
越	走 戉
趌	走 吉
趍	走 多
趎	走 朱
趏	走 舌
趐	走 羽
趑	走 次
趒	走 兆
趓	走 朵
趔	走 列
趕	走 旱
趖	走 坐
趗	走 足
趘	走 尾
趙	走 肖
趚	走 束
趛	走 金
趜	走 匊
趝	走 念
趞	走 昔
趟	走 尚
趠	走 卓
趡	走 崔
趢	走 录
趣	走 取
趤	走 宕
趥	走 酋
趦	走 咨
趧	走 是
趨	走 芻
趩	走 異
趪	走 黃
趫	走 喬
趬	走 堯
趭	走 焦
趮	走 喿
趯	走 翟
趲	走 贊
足	口 卜 人
趴	足 八
趵	足 勺
趶	足 于
趷	足 乞
趹	足 夬
趺	足 夫
趻	足 今
趼	足 开
趽	足 方
趾	足 止
趿	足 及
跀	足 月
跁	足 巴
跂	足 支
跅	足 斥
跆	足 台
跇	足 世
跈	足 人 彡
跉	足 令
跊	足 未
跋	足 犮
跌	足 失
跍	足 古
跎	足 它
跏	足 加
跐	足 此
跑	足 包
跒	足 可
跓	足 主
跔	足 句
跕	足 占
跖	足 石
跗	足 付
跘	足 半
跙	足 且
跚	足 冊
跛	足 皮
跜	足 尼
距	足 巨
跟	足 艮
跠	足 夷
跡	足 亦
跢	足 多
跣	足 先
跤	足 交
跥	足 朶
跦	足 朱
跧	足 全
跨	足 夸
跩	足 曳
跪	足 危
跫	巩 足
跬	足 圭
跭	足 夅
跮	足 至
路	足 各
跰	足 并	足 幷
跱	足 寺
跲	足 合
跳	足 兆
跴	足 西
跺	足 朵
跼	足 局
跽	足 忌
跾	攸 足
跿	足 走
踀	足 足
踁	足 巠
踂	足 耴
踃	足 肖
踄	足 步
踅	折 足
踆	足 夋
踇	足 每
踈	足 束
踉	足 良
踋	足 却
踍	足 孝
踎	足 否
踏	足 沓
踐	足 戔
踑	足 其
踒	足 委
踓	足 隹
踔	足 卓
踕	足 疌
踖	足 昔
踗	足 念
踘	足 匊
踙	足 取
踚	足 侖
踛	足 坴
踜	足 夌
踝	足 果
踞	足 居
踟	足 知
踠	足 宛
踡	足 卷
踢	足 易
踣	足 咅
踤	足 卒
踥	足 妾
踦	足 奇
踧	足 叔
踨	足 從
踩	足 采
踫	足 並
踭	足 爭
踮	足 店
踰	足 俞
踱	足 度
踲	足 盾
踳	足 春
踴	足 勇
踵	足 重
踶	足 是
踷	足 者
踸	足 甚
踹	足 耑
踺	足 建
踻	足 咼
踼	足 昜
踽	足 禹
踾	足 畐
踿	足 秋
蹀	足 枼
蹁	足 扁
蹂	足 柔
蹃	足 若
蹄	足 帝
蹅	足 查
蹆	足 退
蹇	宀 井 大 足
蹈	足 舀
蹉	足 差
蹊	足 奚
蹋	足 日 羽
蹌	足 倉
蹍	足 展
蹎	足 真
蹏	足 虒
蹐	足 脊
蹓	足 留
蹔	斬 足
蹕	足 畢
蹖	足 舂
蹗	足 鹿
蹘	足 翏
蹙	戚 足
蹚	足 堂
蹛	足 帶
蹜	足 宿
蹝	足 徙
蹞	足 頃
蹟	足 責
蹠	足 庶
蹡	足 將
蹢	足 啇
蹣	足 廿 冂 丨 入 入	足 㒼
蹤	足 從
蹥	足 連
蹦	足 崩
蹧	足 曹
蹨	足 然
蹩	敝 足
蹪	足 貴
蹫	足 矞
蹬	足 登
蹭	足 曾
蹮	足 西 大 己	足 覀 大 己
蹯	足 番
蹱	足 童
蹲	足 尊
蹳	足 發
蹴	足 就
蹵	就 足
蹶	足 厥
蹷	厥 足
蹸	足 粦
蹹	足 翕
蹺	足 堯
蹻	足 喬
蹼	足 菐
蹽	足 尞
蹾	足 敦
躀	足 貫
躁	足 品 木	足 喿
躂	足 達
躃	足 辟
躄	辟 足
躅	足 蜀
躆	足 豦
躇	足 著
躈	足 敫
躉	萬 足
躊	足 壽
躋	足 齊
躌	足 舞
躍	足 翟
躎	足 爾
躐	足 巤
躑	足 鄭
躒	足 樂
躓	足 質
躔	足 廛
躕	足 廚
躖	足 丨 二 幺 幺 幺 幺
躗	衛 足
躘	足 龍
躙	足 閵
躚	足 遷
躛	衞 足
躝	足 闌
躞	足 燮
躟	足 襄
躠	薛 足
躡	足 聶
躢	足 闒
躣	足 瞿
躤	足 藉
躥	足 竄
躦	足 贊
躧	足 麗
躨	足 夔
躩	足 矍
躪	足 藺
身	丶 且 丿
躬	身 弓
躭	身 冘
躰	身 本
躱	身 朶
躲	身 朵
躳	身 吕
躴	身 良
躶	身 果
躷	身 委
躸	身 奇
躹	身 匊
躺	身 尚
躽	身 匽
躿	身 康
軀	身 區
軁	身 婁
軂	身 勞
軃	身 單
軄	身 戠
軆	身 豐
軇	身 壽
軉	身 寶
車	一 日 十
軋	車 乚
軌	車 九
軍	冖 車
軎	車 口
軏	車 兀
軐	車 卂
軑	車 大
軒	車 干
軓	車 凡
軔	車 刃
軕	車 山
軖	車 王
軗	車 殳
軘	車 屯
軙	車 攴	車 攵
軚	車 太
軛	車 厄
軜	車 內
軝	車 氏
軞	車 毛
軟	車 欠
軠	車 壬
軡	車 今
転	車 云
軣	車 丷 八
軤	車 乎
軥	車 句
軦	車 兄
軧	車 氐
軨	車 令
軩	車 台
軪	車 幼
軫	車 人 彡
軬	厶 大 車
軭	車 匡
軮	車 央
軯	車 平
軰	北 車
軱	車 瓜
軲	車 古
軳	車 包
軴	車 主
軵	車 付
軶	車 戹
軷	車 犮
軸	車 由
軹	車 只
軺	車 召
軻	車 可
軼	車 失
軽	車 圣
軾	車 式
軿	車 并	車 幷
輀	車 而
輁	車 共
輂	共 車
較	車 交
輄	車 光
輅	車 各
輆	車 亥
輇	車 全
輈	車 舟
載	十 戈 車	土 戈 車	𢦏 車
輊	車 至
輋	山 大 車
輌	車 両
輍	車 谷
輎	車 肖
輏	車 酉
輐	車 完
輑	車 君
輒	車 耴
輓	車 免
輔	車 甫
輕	車 巠
輖	車 周
輗	車 兒
輘	車 夌
輙	車 取
輚	車 戔
輛	車 兩
輜	車 甾
輝	車 軍
輞	車 罔
輟	車 叕
輠	車 果
輡	車 臽
輢	車 奇
輣	車 朋
輤	車 青
輥	車 昆
輦	夫 夫 車
輧	車 幷
輨	車 官
輩	非 車
輪	車 侖
輫	車 非
輬	車 京
輭	車 耎
輮	車 柔
輯	車 咠	車 口 耳
輰	車 昜
輱	車 咸
輲	車 耑
輳	車 奏
輴	車 盾
輵	車 曷
輶	車 酋
輷	車 訇
輸	車 俞
輹	車 复
輺	車 甾 一
輻	車 畐
輼	車 昷
輽	車 畚
輾	車 展
輿	臼 車 一 八
轀	車 昷
轁	車 舀
轂	士 冖 一 車 殳
轃	車 秦
轄	車 害
轅	車 袁
轆	車 鹿
轇	車 翏
轈	車 巢
轉	車 專
轊	車 彗
轋	車 連
轍	車 彳 育 攵
轎	車 喬
轏	車 孱
轐	車 菐
轑	車 尞
轒	車 賁
轓	車 番
轔	車 粦
轕	車 葛
轖	車 嗇
轗	車 感
轘	車 睘
轙	車 義
轚	車 凵 殳
轛	車 對
轜	車 需
轝	與 車
轞	車 監
轟	車 車 車
轠	車 畾
轡	絲 車 口
轢	車 樂
轣	車 歷
轤	車 盧
轥	車 藺
辛	立 十
辜	古 辛
辝	台 辛
辟	尸 口 辛
辠	自 辛
辡	辛 辛
辢	束 辛
辣	辛 束
辤	受 辛
辥	屮 戶 乛 一 辛	屮 户 乛 一 辛
辦	辛 力 辛
辧	辛 刀 辛
辨	辛 丶 丿 辛
辬	辛 文 辛
辭	爪 龴 冂 厶 又 辛	爫 龴 冂 厶 又 辛
辮	辛 絲 辛	辛 糸 辛
辯	辛 言 辛	辛 訁 辛
辰	厂 衣
辱	辰 寸
農	曲 辰
辳	林 辰
辴	單 辰
辵	彡 丨 一 人
辸	辵 乃	辶 乃
辺	辵 刀	辶 刀
辻	辵 十	辶 十
辿	辵 山	辶 山
迀	辵 干	辶 干
迂	辵 于	辶 于
迃	辵 亏	辶 亏
迄	辵 乞	辶 乞
迅	辵 卂	辶 卂
迆	辵 也	辶 也
迉	辵 尸	辶 尸
迊	辵 币	辶 币
迋	辵 王	辶 王
迍	辵 屯	辶 屯
迎	辵 卬	辶 卬
迏	辵 太	辶 太
近	辵 斤	辶 斤
迒	辵 亢	辶 亢
迓	辵 牙	辶 牙
返	辵 反	辶 反
迕	辵 午	辶 午
迖	辵 犬	辶 犬	达 丶
迗	辵 天	辶 天
迠	辵 占	辶 占
迡	辵 尼	辶 尼
迢	辵 召	辶 召
迣	辵 世	辶 世
迤	辵 丿 一 也	辶 丿 一 也
迥	辵 冋	辶 冋
迦	辵 加	辶 加
迧	辵 申	辶 申
迨	辵 台	辶 台
迪	辵 由	辶 由
迫	辵 白	辶 白
迬	辵 主	辶 主
迭	辵 失	辶 失
迮	辵 乍	辶 乍
迯	辵 外	辶 外
述	辵 术	辶 术
迱	辵 它	辶 它
迴	辵 回	辶 回
迵	辵 同	辶 同
迷	辵 米	辶 米
迸	辵 并	辶 并	辵 幷	辶 幷
迺	辵 西	辶 西
迻	辵 多	辶 多
迼	辵 吉	辶 吉
追	辵 戶 乛 一	辶 戶 乛 一	辵 户 乛 一	辶 户 乛 一
迾	辵 列	辶 列
迿	辵 旬	辶 旬
退	辵 艮	辶 艮
送	辵 关	辶 关
逃	辵 兆	辶 兆
逄	辵 夅	辶 夅
逅	辵 后	辶 后
逆	辵 屰	辶 屰
逇	辵 地	辶 地
逈	辵 向	辶 向
逋	辵 甫	辶 甫
逌	辵 卣	辶 卣
逍	辵 肖	辶 肖
逎	辵 酉	辶 酉
透	辵 秀	辶 秀
逐	辵 豕	辶 豕
逑	辵 求	辶 求
逓	辵 乕	辶 乕
途	辵 余	辶 余
逕	辵 巠	辶 巠
逕	辵 巠	辶 巠
逖	辵 狄	辶 狄
逗	辵 豆	辶 豆
逘	辵 矣	辶 矣
這	辵 言	辶 言
通	辵 甬	辶 甬
逛	辵 狂	辶 狂
逜	辵 吾	辶 吾
逝	辵 折	辶 折
逞	辵 呈	辶 呈
速	辵 束	辶 束
造	辵 告	辶 告
逡	辵 夋	辶 夋
逢	辵 夆	辶 夆
連	辵 車	辶 車
逤	辵 沙	辶 沙
逥	辵 囬	辶 囬
逨	辵 來	辶 來
逩	辵 奔	辶 奔
逪	辵 昔	辶 昔
逫	辵 叕	辶 叕
逬	辵 幷	辶 幷
逭	辵 官	辶 官
逮	辵 隶	辶 隶
逯	辵 彔	辶 彔
逰	辵 手 丿 一 子	辶 手 丿 一 子
週	辵 周	辶 周
進	辵 隹	辶 隹
逳	辵 育	辶 育
逴	辵 卓	辶 卓
逵	辵 坴	辶 坴
逶	辵 委	辶 委
逷	辵 易	辶 易
逸	辵 免	辶 免
逺	辵 土 𠃊 	辶 土 𠃊 
逼	辵 畐	辶 畐
逽	辵 若	辶 若
逾	辵 俞	辶 俞
逿	辵 昜	辶 昜
遀	辵 左 月	辶 左 月
遁	辵 盾	辶 盾
遂	辵 丷 豕	辶 丷 豕
遃	辵 彦	辶 彦
遄	辵 耑	辶 耑
遆	辵 帝	辶 帝
遇	辵 禺	辶 禺
遈	辵 是	辶 是
遉	辵 貞	辶 貞
遊	辵 斿	辶 斿
運	辵 軍	辶 軍
遌	辵 咢	辶 咢
遍	辵 扁	辶 扁
過	辵 咼	辶 咼
遏	辵 曷	辶 曷
遐	辵 叚	辶 叚
遑	辵 皇	辶 皇
遒	辵 酋	辶 酋
道	辵 首	辶 首
達	辵 土 羊	辶 土 羊	辵 幸	辶 幸
違	辵 韋	辶 韋
遘	辵 冓	辶 冓
遙	辵 月 缶	辶 月 缶	辵 䍃	辶 䍃
遚	辵 叟	辶 叟
遛	辵 留	辶 留
遜	辵 孫	辶 孫
遝	辵 眔	辶 眔
遞	辵 厂 虎	辶 厂 虎
遟	辵 屖	辶 屖
遠	辵 袁	辶 袁
遡	辵 朔	辶 朔
遢	辵 日 羽	辶 日 羽	辵 曰 羽	辶 曰 羽
遣	辵 中 一 尸 乛 一	辶 辵 中 一 尸 乛 一
遦	辵 貫	辶 貫
遧	辵 章	辶 章
遨	辵 敖	辶 敖
適	辵 啇	辶 啇
遪	辵 參	辶 參
遫	辵 敕	辶 敕
遬	辵 欶	辶 欶
遭	辵 曹	辶 曹
遮	辵 庶	辶 庶
遯	辵 豚	辶 豚
遰	辵 帶	辶 帶
遱	辵 婁	辶 婁
遲	辵 犀	辶 犀
遳	辵 莝	辶 莝
遴	辵 粦	辶 粦
遵	辵 尊	辶 尊
遶	辵 堯	辶 堯
遷	辵 西 大 己	辶 覀 大 己
選	辵 巽	辶 巽
遹	辵 矞	辶 矞
遺	辵 貴	辶 貴
遻	辵 口 口 屰	辶 口 口 屰
遼	辵 尞	辶 尞
遽	辵 豦	辶 豦
遾	辵 筮	辶 筮
避	辵 辟	辶 辟
邀	辵 敫	辶 敫
邁	辵 萬	辶 萬
邂	辵 解	辶 解
邃	穴 遂	辵 穴 丷 豕	辶 穴 丷 豕
還	辵 睘	辶 睘
邅	辵 亶	辶 亶
邆	辵 登	辶 登
邇	辵 爾	辶 爾
邈	辵 貌	辶 貌
邉	辵 自 冖 八 口	辶 自 冖 八 口
邊	辵 自 穴 方	辶 自 穴 方	辵 臱	辶 臱
邋	辵 巤	辶 巤
邌	辵 黎	辶 黎
邍	辵 备 录	辶 备 录
邎	辵 夕 言 系	辶 夕 言 系
邏	辵 羅	辶 羅
邐	辵 麗	辶 麗
邑	口 巴
邒	丁 邑	丁 阝
邔	己 邑	己 阝
邕	巛 邑
邖	山 邑	山 阝
邗	干 邑	干 阝
邘	于 邑	于 阝
邙	亡 邑	亡 阝
邚	女 邑	女 阝
邛	工 邑	工 阝
邞	夫 邑	夫 阝
邟	亢 邑	亢 阝
邠	分 邑	分 阝
邡	方 邑	方 阝
邢	开 邑	开 阝
那	月 邑	月 阝
邥	冘 邑	冘 阝
邦	丰 邑	丰 阝
邧	元 邑	元 阝
邨	屯 邑	屯 阝
邩	火 邑	火 阝
邪	牙 邑	牙 阝
邫	丰 邑
邭	句 邑	句 阝
邯	甘 邑	甘 阝
邰	台 邑	台 阝
邱	丘 邑	丘 阝
邲	必 邑	必 阝
邳	丕 邑	丕 阝
邴	丙 邑	丙 阝
邵	召 邑	召 阝
邶	北 邑	北 阝
邷	瓦 邑	瓦 阝
邸	氐 邑	氐 阝	氏 丶 邑
邼	匡 邑	匡 阝
邽	圭 邑	圭 阝
邾	朱 邑	朱 阝
邿	寺 邑	寺 阝
郀	夸 邑	夸 阝
郁	有 邑	有 阝
郂	亥 邑	亥 阝
郃	合 邑	合 阝
郄	乂 厷 邑	乂 厷 阝
郅	至 邑	至 阝
郆	吉 邑	吉 阝
郇	旬 邑	旬 阝
郈	后 邑	后 阝
郉	幵 邑	幵 阝
郊	交 邑	交 阝
郋	自 邑	自 阝
郌	圭 邑
郍	舟 邑	舟 阝
郎	良 邑	良 阝
郔	延 邑	延 阝
郕	成 邑	成 阝
郖	豆 邑	豆 阝
郗	希 邑	希 阝
郘	呂 邑	呂 阝
郙	甫 邑	甫 阝
郚	吾 邑	吾 阝
郛	孚 邑	孚 阝
郜	告 邑	告 阝
郝	赤 邑	赤 阝
郞	良 邑	良 阝
郟	夾 邑	夾 阝
郠	更 邑	更 阝
郡	君 邑	君 阝
郢	呈 邑	呈 阝
郣	孛 邑	孛 阝
郤	谷 邑	谷 阝
郥	貝 邑	貝 阝
部	咅 邑	咅 阝
郩	肴 邑	肴 阝
郪	妻 邑	妻 阝
郫	卑 邑	卑 阝
郬	青 邑	青 阝
郭	享 邑	享 阝
郯	炎 邑	炎 阝
郰	取 邑	取 阝
郱	并 邑	并 阝	幷 邑	幷 阝
郲	來 邑	來 阝
郳	兒 邑	兒 阝
郴	林 邑	林 阝
郵	垂 邑	垂 阝
郶	咅 邑
郷	乡 艮 邑	乡 艮 阝
郹	狊 邑	狊 阝
郺	多 邕
郻	目 丨 一 巛 邑	目 丨 一 巛 阝
郼	韋 邑	韋 阝
都	者 邑	者 阝
郾	匽 邑	匽 阝
郿	眉 邑	眉 阝
鄀	若 邑	若 阝
鄁	背 邑	背 阝
鄂	咢 邑	咢 阝
鄃	俞 邑	俞 阝
鄄	垔 邑	垔 阝
鄅	禹 邑	禹 阝
鄆	軍 邑	軍 阝
鄇	侯 邑	侯 阝
鄈	癸 邑	癸 阝
鄉	乡 郎
鄊	乡 耶 邑	乡 耶 阝
鄋	叟 邑	叟 阝
鄌	唐 邑	唐 阝
鄍	冥 邑	冥 阝
鄎	息 邑	息 阝
鄏	辱 邑	辱 阝
鄐	畜 邑	畜 阝
鄑	晉 邑	晉 阝
鄒	芻 邑	芻 阝
鄓	臭 邑	臭 阝
鄔	烏 邑	烏 阝
鄕	乡 郎 邑	乡 郎 阝
鄖	員 邑	員 阝
鄗	高 邑	高 阝
鄘	庸 邑	庸 阝
鄙	啚 邑	啚 阝
鄚	莫 邑	莫 阝
鄛	巢 邑	巢 阝
鄜	鹿 邑	鹿 阝
鄝	翏 邑	翏 阝
鄞	堇 邑	堇 阝
鄟	專 邑	專 阝
鄠	雩 邑	雩 阝
鄡	梟 邑	梟 阝
鄢	焉 邑	焉 阝
鄣	章 邑	章 阝
鄤	曼 邑	曼 阝
鄥	鳥 邑	鳥 阝
鄦	無 邑	無 阝
鄧	登 邑	登 阝
鄨	敝 邑
鄩	尋 邑	尋 阝
鄪	費 邑	費 阝
鄫	曾 邑	曾 阝
鄬	為 邑	為 阝
鄭	奠 邑	阝 邑
鄮	冒 邑	冒 阝
鄯	善 邑	善 阝
鄰	粦 邑	粦 阝
鄱	番 邑	番 阝
鄲	單 邑	單 阝
鄳	黽 邑	黽 阝
鄴	業 邑	業 阝
鄵	喿 邑	喿 阝
鄶	會 邑	會 阝
鄷	豊 邑	豊 阝
鄸	夢 邑	夢 阝
鄹	聚 邑	聚 阝
鄺	廣 邑	廣 阝
鄻	輦 邑	輦 阝
鄼	賛 邑	賛 阝
鄽	廛 邑	廛 阝
鄾	憂 邑	憂 阝
鄿	蕇 邑	蕇 阝
酀	燕 邑	燕 阝
酁	毚 邑	毚 阝
酃	霝 邑	霝 阝
酄	雚 邑	雚 阝
酅	巂 邑	巂 阝
酆	豐 邑	豐 阝
酇	贊 邑	贊 阝
酈	麗 邑	麗 阝
酉	西 一
酊	酉 丁
酋	丷 酉
酌	酉 勺
配	酉 己
酎	酉 寸
酏	酉 也
酐	酉 干
酑	酉 于
酒	水 酉	氵 酉
酓	今 酉
酔	酉 卆
酕	酉 毛
酖	酉 冘
酗	酉 凶
酘	酉 殳
酙	酉 斗
酚	酉 分
酞	酉 太
酟	酉 占
酠	酉 可
酡	酉 它
酢	酉 乍
酣	酉 甘
酤	酉 古
酥	酉 禾
酧	酉 守
酨	十 戈 酉	土 戈 酉	𢦏 酉
酩	酉 名
酪	各 酉
酫	酉 全
酬	酉 州
酭	酉 有
酮	酉 同
酯	酉 旨
酰	酉 先
酲	酉 呈
酳	酉 幺 肉	酉 幺 月
酴	酉 余
酵	酉 孝
酶	酉 每
酷	酉 告
酸	酉 夋
酹	酉 寽
酺	酉 甫
酻	酉 孚
酼	酉 亠 厶 川	酉 巟	酉 㐬
醀	酉 隹
醁	酉 彔
醂	酉 林
醃	酉 奄
醄	酉 匋
醅	酉 咅
醆	酉 戔
醇	酉 享
醈	酉 炎
醉	酉 卒
醊	酉 叕
醋	酉 昔
醌	酉 昆
醍	酉 是
醎	酉 咸
醏	酉 者
醐	酉 胡
醑	酉 胥
醒	酉 星
醓	酉 冘 皿
醔	秋 酉
醕	酉 亯
醖	酉 昷
醗	酉 発
醘	酉 盍
醙	酉 叟
醚	酉 迷
醛	酉 荃
醜	酉 鬼
醝	酉 差
醞	酉 昷
醟	火 火 冖 酉	𤇾 酉
醠	酉 盎
醡	酉 窄
醢	酉 右 皿
醣	酉 唐
醤	将 酉
醥	酉 票
醦	酉 參
醧	酉 區
醨	酉 离
醩	酉 曹
醪	酉 翏
醫	殹 酉
醬	將 酉
醭	酉 菐
醮	酉 焦
醯	酉 亠 厶 川 皿	酉 巟 皿	酉 㐬 皿
醰	酉 覃
醱	酉 發
醲	酉 農
醳	酉 睪
醴	酉 豊
醵	酉 豦
醶	酉 僉
醷	酉 意
醸	酉 六 井 一 
醹	酉 需
醺	酉 熏
醻	酉 壽
醼	酉 燕
醽	酉 霝
醾	酉 糜
醿	酉 縻
釀	酉 襄
釁	臼 同 冖 酉 分
釂	酉 爵
釃	酉 麗
釄	酉 靡
釅	酉 嚴
釆	丿 米
采	爪 木	爫 木
釈	釆 尺
釉	采 由	釆 由
釋	采 睪	釆 睪
里	甲 二	田 土	曰 土
重	丿 一 里
野	里 予
量	日 一 里	曰 一 里
釐	未 攴 厂 里	未 攵 厂 里
金	人 王 丷
釒	人 王 丷
釓	金 乚	釒 乚
釔	金 乙	釒 乙
釕	金 了	釒 了
釖	金 刀	釒 刀
釗	金 刀	釒 刂
釘	金 丁	釒 丁
釙	金 卜	釒 卜
釚	金 九	釒 九
釛	金 力	釒 力
釜	父 金
針	金 十	釒 十
釞	金 入	釒 入
釟	金 八	釒 八
釠	金 几	釒 几
釡	八 金
釢	金 乃	釒 乃
釣	金 勺	釒 勺
釤	金 彡	釒 彡
釥	金 小	釒 小
釦	金 口	釒 口
釧	金 川	釒 川
釨	金 子	釒 子
釩	金 凡	釒 凡
釪	金 于	釒 于
釫	金 亏	釒 亏
釬	金 干	釒 干
釭	金 工	釒 工
釮	金 才	釒 才
釯	金 亡	釒 亡
釰	金 刃	釒 刃
釱	金 大	釒 大
釲	金 巳	釒 巳
釳	金 乞	釒 乞
釴	金 弋	釒 弋
釵	金 叉	釒 叉
釶	金 也	釒 也
釷	金 土	釒 土
釸	金 夕	釒 夕
釹	金 女	釒 女
釺	金 千	釒 千
釼	金 刄	釒 刄
釽	金 爪	釒 爪
釾	金 牙	釒 牙
釿	金 斤	釒 斤
鈀	金 巴	釒 巴
鈁	金 方	釒 方
鈂	金 冘	釒 冘
鈃	金 开	釒 开
鈄	金 斗	釒 斗
鈅	金 月	釒 月
鈆	金 公	釒 公
鈇	金 夫	釒 夫
鈈	金 不	釒 不
鈉	金 內	釒 內
鈊	金 心	釒 心
鈋	金 化	釒 化
鈌	金 夬	釒 夬
鈍	金 屯	釒 屯
鈎	金 勾	釒 勾
鈏	金 引	釒 引
鈐	金 今	釒 今
鈑	金 反	釒 反
鈒	金 及	釒 及
鈓	金 壬	釒 壬
鈔	金 少	釒 少
鈕	金 丑	釒 丑
鈖	金 分	釒 分
鈗	金 允	釒 允
鈘	金 支	釒 支
鈙	金 攴	釒 攴
鈚	金 比	釒 比
鈛	金 戈	釒 戈
鈜	金 厷	釒 厷
鈝	金 牛	釒 牛
鈞	金 勻	釒 勻
鈟	金 弔	釒 弔
鈠	金 殳	釒 殳
鈡	金 中	釒 中
鈢	金 木	釒 木
鈣	金 丐	釒 丐
鈤	金 日	釒 日
鈥	金 火	釒 火
鈦	金 太	釒 太
鈧	金 亢	釒 亢
鈪	金 厄	釒 厄
鈬	金 尺	釒 尺
鈭	此 金
鈮	金 尼	釒 尼
鈯	金 出	釒 出
鈰	金 市	釒 市
鈱	金 民	釒 民
鈲	金 瓜	釒 瓜
鈳	金 可	釒 可
鈴	金 令	釒 令
鈵	金 丙	釒 丙
鈶	金 台	釒 台
鈷	金 古	釒 古
鈸	金 犮	釒 犮
鈹	金 皮	釒 皮
鈺	金 玉	釒 玉
鈻	金 尸 乛 一	釒 尸 乛 一
鈼	金 乍	釒 乍
鈽	金 布	釒 布
鈾	金 由	釒 由
鈿	金 田	釒 田
鉀	金 甲	釒 甲
鉁	金 人 彡	釒 人 彡
鉂	金 史	釒 史
鉃	金 矢	釒 矢
鉄	金 失	釒 失
鉅	金 巨	釒 巨
鉆	金 占	釒 占
鉇	金 丿 一 也	釒 丿 一 也
鉈	金 它	釒 它
鉉	金 玄	釒 玄
鉊	金 召	釒 召
鉋	金 包	釒 包
鉌	金 禾	釒 禾
鉍	金 必	釒 必
鉎	金 生	釒 生
鉏	金 且	釒 且
鉐	金 石	釒 石
鉑	金 白	釒 白
鉒	金 主	釒 主
鉓	金 丿 一 巾	釒 丿 一 巾	金 布	釒 布
鉔	金 匝	釒 匝
鉕	金 叵	釒 叵
鉖	金 冬	釒 冬
鉗	金 甘	釒 甘
鉘	金 弗	釒 弗
鉙	金 只	釒 只
鉚	金 卯	釒 卯
鉛	金 八 口	釒 八 口
鉜	金 付	釒 付
鉝	金 立	釒 立
鉞	金 戉	釒 戉
鉟	金 丕	釒 丕
鉠	金 央	釒 央
鉡	金 半	釒 半
鉢	金 本	釒 本
鉤	金 句	釒 句
鉥	金 朮	釒 朮
鉦	金 正	釒 正
鉧	金 母	釒 母
鉨	金 尔	釒 尔
鉩	金 尒	釒 尒
鉪	金 世	釒 世
鉫	金 加	釒 加
鉬	金 目	釒 目
鉭	金 旦	釒 旦
鉮	金 申	釒 申
鉯	金 以	釒 以
鉰	金 司	釒 司
鉱	金 広	釒 広
鉲	金 卡	釒 卡
鉳	金 北	釒 北
鉵	金 蟲	釒 蟲	金 虫	釒 虫
鉶	金 刑	釒 刑
鉷	金 共	釒 共
鉸	金 交	釒 交
鉹	金 多	釒 多
鉺	金 耳	釒 耳
鉻	金 各	釒 各
鉼	金 并	釒 并	金 幷	釒 幷
鉽	金 式	釒 式
鉾	金 牟	釒 牟
鉿	金 合	釒 合
銀	金 艮	釒 艮
銁	金 旬	釒 旬
銂	金 州	釒 州
銃	金 充	釒 充
銄	金 向	釒 向
銅	金 同	釒 同
銆	金 百	釒 百
銇	金 耒	釒 耒
銈	金 圭	釒 圭
銉	金 聿	釒 聿
銊	金 戌	釒 戌
銋	金 任	釒 任
銌	金 存	釒 存
銍	金 至	釒 至
銎	金 巩	釒 巩
銏	金 册	釒 册
銐	列 金
銑	金 先	釒 先
銒	金 幵	釒 幵
銓	金 全	釒 全
銔	金 不 十	釒 不 十
銕	金 夷	釒 夷
銖	金 朱	釒 朱
銗	金 后	釒 后
銘	金 名	釒 名
銙	金 夸	釒 夸
銚	金 兆	釒 兆
銛	金 舌	釒 舌
銜	行 金	行 釒
銝	金 休	釒 休
銞	旬 金
銟	金 山 巾	釒 山 巾
銠	金 老	釒 老
銡	金 吉	釒 吉
銢	金 二 水	釒 二 水
銣	金 如	釒 如
銤	金 米	釒 米
銥	金 衣	釒 衣
銦	金 因	釒 因
銧	金 光	釒 光
銨	金 安	釒 安
銩	金 丟	釒 丟
銪	金 有	釒 有
銫	金 色	釒 色
銬	金 考	釒 考
銭	金 一 戋	釒 一 戋
銰	金 艾	釒 艾
銱	金 吊	釒 吊
銲	金 旱	釒 旱
銳	金 兌	釒 兌
銴	折 金
銵	金 身	釒 身
銶	金 求	釒 求
銷	金 肖	釒 肖
銸	金 耴	釒 耴
銹	金 秀	釒 秀
銺	壯 金
銻	金 弟	釒 弟
銼	金 坐	釒 坐
銽	金 氏 口	釒 氏 口
銾	金 汞	釒 汞
銿	金 甬	釒 甬
鋀	金 豆	釒 豆
鋁	金 呂	釒 呂
鋂	金 每	釒 每
鋃	金 良	釒 良
鋄	金 灭 又	釒 灭 又
鋅	金 辛	釒 辛
鋆	均 金
鋇	金 貝	釒 貝
鋈	沃 金
鋉	金 束	釒 束
鋊	金 谷	釒 谷
鋋	金 延	釒 延
鋌	金 廷	釒 廷
鋍	金 孛	釒 孛
鋎	金 完	釒 完
鋏	金 夾	釒 夾
鋐	金 宏	釒 宏
鋑	金 夋	釒 夋
鋒	金 夆	釒 夆
鋓	金 利	釒 利
鋔	金 免	釒 免
鋕	金 志	釒 志
鋖	金 妥	釒 妥
鋗	金 肙	釒 肙
鋘	金 吳	釒 吳
鋙	金 吾	釒 吾
鋚	攸 金
鋛	金 串	釒 串
鋜	金 足	釒 足
鋝	金 寽	釒 寽
鋞	金 巠	釒 巠
鋟	金 彐 冖 又	釒 彐 冖 又
鋠	金 辰	釒 辰
鋡	金 含	釒 含
鋢	金 孚	釒 孚
鋣	金 邪	釒 邪
鋤	金 助	釒 助
鋥	金 呈	釒 呈
鋦	金 局	釒 局
鋧	金 見	釒 見
鋨	金 我	釒 我
鋩	金 芒	釒 芒
鋪	金 甫	釒 甫
鋫	利 金
鋬	扳 金
鋭	金 兑	釒 兑
鋮	金 成	釒 成
鋯	金 告	釒 告
鋰	金 里	釒 里
鋱	金 忒	釒 忒
鋳	金 寿	釒 寿
鋵	金 禿	釒 禿
鋶	金 亠 厶 川	釒 亠 厶 川	金 巟	釒 巟	金 㐬	釒 㐬
鋷	金 取	釒 取
鋸	金 居	釒 居
鋹	金 長	釒 長
鋺	金 宛	釒 宛
鋻	臤 金
鋼	金 岡	釒 岡
鋽	金 卓	釒 卓
鋾	金 匋	釒 匋
鋿	金 尚	釒 尚
錀	金 侖	釒 侖
錁	金 果	釒 果
錂	金 夌	釒 夌
錃	波 金
錄	金 彔	釒 彔
錅	禾 勹 丿 金
錆	金 青	釒 青
錇	金 咅	釒 咅
錈	金 卷	釒 卷
錉	金 昏	釒 昏
錊	金 卒	釒 卒
錋	金 朋	釒 朋
錌	金 岸	釒 岸
錍	金 卑	釒 卑
錎	金 臽	釒 臽
錏	金 亞	釒 亞
錐	金 隹	釒 隹
錑	金 戾	釒 戾
錒	金 阿	釒 阿
錓	金 羌	釒 羌
錔	金 沓	釒 沓
錕	金 昆	釒 昆
錖	叔 金
錗	金 委	釒 委
錘	金 垂	釒 垂
錙	金 甾	釒 甾
錚	金 爭	釒 爭
錛	金 奔	釒 奔
錜	金 念	釒 念
錝	金 宗	釒 宗
錞	金 享	釒 享
錟	金 炎	釒 炎
錠	金 定	釒 定
錡	金 奇	釒 奇
錢	金 戔	釒 戔
錣	金 叕	釒 叕
錤	金 其	釒 其
錥	金 育	釒 育
錦	金 帛	釒 帛
錧	金 官	釒 官
錨	金 苗	釒 苗
錩	金 昌	釒 昌
錪	金 典	釒 典
錫	金 易	釒 易
錬	金 東	釒 東
錭	金 周	釒 周
錮	金 固	釒 固
錯	金 昔	釒 昔
錰	金 杰	釒 杰
錱	金 王 王
録	金 录	釒 录
錳	金 孟	釒 孟
錴	金 坴	釒 坴
錵	金 花	釒 花
錶	金 表	釒 表
錷	金 軋	釒 軋
錸	金 來	釒 來
錹	金 肯	釒 肯
錼	金 奈	釒 奈
錽	金 灭 夕	釒 灭 夂
鍀	金 日 一 寸	釒 日 一 寸	金 㝵	釒 㝵
鍁	金 欣	釒 欣
鍃	金 忽	釒 忽
鍄	金 京	釒 京
鍆	金 門	釒 門
鍇	金 皆	釒 皆
鍈	金 英	釒 英
鍉	金 是	釒 是
鍊	金 柬	釒 柬
鍋	金 咼	釒 咼
鍌	洗 金
鍍	金 度	釒 度
鍎	金 盾	釒 盾
鍏	金 韋	釒 韋
鍐	金 凶 儿 夕	釒 凶 儿 夂
鍑	金 复	釒 复
鍒	金 柔	釒 柔
鍓	金 咠	釒 咠
鍔	金 咢	釒 咢
鍕	金 軍	釒 軍
鍖	金 甚	釒 甚
鍗	金 帝	釒 帝
鍘	金 則	釒 則
鍙	洪 金
鍚	金 昜	釒 昜
鍛	金 段	釒 段
鍜	金 叚	釒 叚
鍝	金 禺	釒 禺
鍞	金 貞	釒 貞
鍟	金 星	釒 星
鍠	金 皇	釒 皇
鍡	金 畏	釒 畏
鍢	金 畐	釒 畐
鍣	金 苕	釒 苕
鍤	金 臿	釒 臿
鍥	金 契	釒 契
鍦	金 施	釒 施
鍧	金 訇	釒 訇
鍨	金 癸	釒 癸
鍩	金 若	釒 若
鍪	敄 金
鍫	秋 金
鍬	金 秋	釒 秋
鍭	金 侯	釒 侯
鍮	金 俞	釒 俞
鍯	金 怱	釒 怱
鍰	金 爰	釒 爰
鍱	金 枼	釒 枼
鍲	金 昬	釒 昬
鍳	臣 丿 一 丶
鍴	金 耑	釒 耑
鍵	金 建	釒 建
鍶	金 思	釒 思
鍷	金 奎	釒 奎
鍸	金 胡	釒 胡
鍹	金 宣	釒 宣
鍺	金 者	釒 者
鍻	金 曷	釒 曷
鍼	金 咸	釒 咸
鍽	金 扁	釒 扁
鍾	金 重	釒 重
鍾	金 重	釒 重
鍿	金 甾 一	釒 甾 一
鎀	金 修	釒 修
鎁	金 耶	釒 耶
鎂	金 美	釒 美
鎃	金 派	釒 派
鎄	金 哀	釒 哀
鎅	金 界	釒 界
鎇	金 眉	釒 眉
鎈	金 差	釒 差
鎉	金 日 羽	釒 日 羽
鎊	金 旁	釒 旁
鎋	金 害	釒 害
鎌	金 廉	釒 廉
鎍	金 索	釒 索
鎎	金 氣	釒 氣
鎏	流 金
鎐	金 爪 缶	釒 爫 缶
鎑	金 盍	釒 盍
鎒	金 辱	釒 辱
鎓	金 翁	釒 翁
鎔	金 容	釒 容
鎕	金 唐	釒 唐
鎖	金 小 貝	釒 小 貝
鎗	金 倉	釒 倉
鎘	金 鬲	釒 鬲
鎙	金 朔	釒 朔
鎚	金 追	釒 追
鎛	金 尃	釒 尃
鎜	般 金
鎝	金 荅	釒 荅
鎞	金 囟 比	釒 囟 比
鎟	金 桑	釒 桑
鎠	金 罡	釒 罡
鎡	金 兹	釒 兹
鎢	金 烏	釒 烏
鎣	火 火 冖 金	𤇾 金
鎤	金 晃	釒 晃
鎥	條 金
鎦	金 留	釒 留
鎧	金 豈	釒 豈
鎨	金 隼	釒 隼
鎩	金 殺	釒 殺
鎪	金 叟	釒 叟
鎫	金 丶 冂 乂 八 夕	釒 丶 冂 乂 八 夂
鎬	金 高	釒 高
鎭	金 眞	釒 眞
鎮	金 真	釒 真
鎯	金 郎	釒 郎
鎰	金 益	釒 益
鎱	金 袁	釒 袁
鎲	金 党	釒 党
鎳	金 臬	釒 臬
鎴	金 息	釒 息
鎵	金 家	釒 家
鎶	金 哥	釒 哥
鎷	金 馬	釒 馬
鎸	金 隽	釒 隽
鎻	金 巛 貝	釒 巛 貝
鎿	金 拿	釒 拿
鏀	金 鹵	釒 鹵
鏁	金 巢	釒 巢
鏂	金 區	釒 區
鏃	金 族	釒 族
鏄	金 專	釒 專
鏅	金 脩	釒 脩
鏆	金 貫	釒 貫
鏇	金 旋	釒 旋
鏈	金 連	釒 連
鏉	金 欶	釒 欶
鏊	敖 金
鏋	金 廿 冂 丨 入 入	釒 廿 冂 丨 入 入	金 㒼	釒 㒼
鏌	金 莫	釒 莫
鏍	金 累	釒 累
鏎	金 畢	釒 畢
鏏	金 彗	釒 彗
鏐	金 翏	釒 翏
鏑	金 啇	釒 啇
鏒	金 參	釒 參
鏓	金 悤	釒 悤
鏔	金 寅	釒 寅
鏕	金 鹿	釒 鹿
鏖	鹿 金
鏗	金 堅	釒 堅
鏘	金 將	釒 將
鏙	金 崔	釒 崔
鏚	金 戚	釒 戚
鏛	金 常	釒 常
鏜	金 堂	釒 堂
鏝	金 曼	釒 曼
鏞	金 庸	釒 庸
鏟	金 產	釒 產
鏠	金 逢	釒 逢
鏡	金 竟	釒 竟
鏢	金 票	釒 票
鏣	金 庶	釒 庶
鏤	金 婁	釒 婁
鏥	金 宿	釒 宿
鏦	金 從	釒 從
鏧	殸 金
鏨	斬 金
鏩	金 斬	釒 斬
鏪	金 曹	釒 曹
鏫	金 梨	釒 梨
鏬	金 虖	釒 虖
鏭	金 悉	釒 悉
鏮	金 康	釒 康
鏰	金 朋	釒 朋
鏳	金 曾	釒 曾
鏴	金 路	釒 路
鏵	金 華	釒 華
鏶	金 集	釒 集
鏷	金 菐	釒 菐
鏸	金 惠	釒 惠
鏹	金 強	釒 強
鏺	金 發	釒 發
鏻	金 粦	釒 粦
鏼	金 策	釒 策
鏽	金 肅	釒 肅
鏾	金 散	釒 散
鏿	金 棠	釒 棠
鐀	金 貴	釒 貴
鐁	金 斯	釒 斯
鐂	金 畱	釒 畱
鐃	金 堯	釒 堯
鐄	金 黃	釒 黃
鐅	敝 金
鐆	隊 金
鐇	金 番	釒 番
鐈	金 喬	釒 喬
鐉	金 巽	釒 巽
鐊	金 陽	釒 陽
鐋	金 湯	釒 湯
鐌	金 象	釒 象
鐍	金 矞	釒 矞
鐎	金 焦	釒 焦
鐏	金 尊	釒 尊
鐐	金 尞	釒 尞 镣
鐑	金 結	釒 結
鐒	金 勞	釒 勞
鐓	金 敦	釒 敦
鐔	金 覃	釒 覃
鐕	金 旡 旡 日	釒 旡 旡 日	金 朁	釒 朁
鐖	金 幾	釒 幾
鐗	金 閒	釒 閒
鐘	金 童	釒 童
鐙	金 登	釒 登
鐚	金 惡	釒 惡
鐛	金 景	釒 景
鐜	享 金
鐝	金 厥	釒 厥
鐞	金 尋	釒 尋
鐟	金 替	釒 替
鐠	金 普	釒 普
鐡	金 十 豆 戈	釒 十 豆 戈
鐤	金 鼎	釒 鼎
鐥	金 善	釒 善
鐦	金 開	釒 開
鐧	金 間	釒 間
鐨	金 費	釒 費
鐩	金 遂	釒 遂
鐪	金 虜	釒 虜
鐫	金 雋	釒 雋
鐬	金 歲	釒 歲
鐭	金 奥	釒 奥
鐮	金 廉	釒 廉
鐯	金 著	釒 著
鐰	金 喿	釒 喿
鐱	金 僉	釒 僉
鐲	金 蜀	釒 蜀
鐳	金 雷	釒 雷
鐴	金 辟	釒 辟
鐵	金 哉 王	釒 哉 王	金 土 口 王 戈	釒 土 口 王 戈
鐶	金 睘	釒 睘
鐷	金 葉	釒 葉
鐸	金 睪	釒 睪
鐹	金 過	釒 過
鐺	金 當	釒 當
鐻	金 豦	釒 豦
鐼	金 賁	釒 賁
鐽	金 達	釒 達
鐾	辟 金
鐿	金 意	釒 意
鑀	金 愛	釒 愛
鑁	金 囟 丶 丶 丶 丶 儿 夕	釒 囟 丶 丶 丶 丶 儿 夂
鑂	金 熏	釒 熏
鑃	金 翟	釒 翟
鑄	金 壽	釒 壽
鑅	金 榮	釒 榮
鑆	金 對	釒 對
鑇	金 齊	釒 齊
鑈	金 爾	釒 爾
鑉	金 蓋	釒 蓋
鑊	金 蒦	釒 蒦
鑋	輕 金
鑌	金 賓	釒 賓
鑍	賏 金
鑎	金 匱	釒 匱
鑏	金 寧	釒 寧
鑐	金 需	釒 需
鑑	金 監	釒 監
鑒	臣 丿 一 丶 网 金	臣 丿 一 丶 罒 金
鑔	金 察	釒 察
鑕	金 質	釒 質
鑖	金 蔑	釒 蔑
鑗	金 黎	釒 黎
鑘	金 畾	釒 畾
鑙	金 禾 尤 旨	釒 禾 尤 旨
鑚	金 賛	釒 賛
鑛	金 廣	釒 廣
鑜	金 賞	釒 賞
鑝	金 蓬	釒 蓬
鑞	金 巤	釒 巤
鑟	金 賣	釒 賣
鑠	金 樂	釒 樂
鑡	金 齒	釒 齒
鑢	金 慮	釒 慮
鑣	金 麃	釒 麃
鑤	金 暴	釒 暴
鑥	金 魯	釒 魯
鑨	金 龍	釒 龍
鑩	金 噩	釒 噩
鑪	金 盧	釒 盧
鑫	金 金 金
鑬	金 覽	釒 覽
鑭	金 闌	釒 闌
鑮	金 薄	釒 薄
鑯	金 韱	釒 韱
鑰	金 龠	釒 龠
鑱	金 毚	釒 毚
鑲	金 襄	釒 襄
鑳	金 蹇	釒 蹇
鑴	金 巂	釒 巂
鑵	金 雚	釒 雚
鑶	金 藏	釒 藏
鑷	金 聶	釒 聶
鑸	金 壘	釒 壘
鑹	金 竄	釒 竄
鑺	金 瞿	釒 瞿
鑻	金 攀	釒 攀
鑼	金 羅	釒 羅
鑽	金 贊	釒 贊
鑾	絲 言 金	糸 言 糸 金	䜌 金
鑿	丵 臼 殳 金
钀	金 獻	釒 獻
钁	金 矍	釒 矍
钂	金 黨	釒 黨
钃	金 屬	釒 屬
钄	金 蘭	釒 蘭
镸	三 丨 一 厶
镹	長 久	镸 久
镺	長 夭	镸 夭
镻	長 失	镸 失
镼	長 屈	镸 屈
镽	長 尞	镸 尞
镾	長 爾	镸 爾
門	尸 一 匸 一 亅
閁	門 丿
閂	門 一
閃	門 人
閄	門 人
閅	門 丁
閆	門 三
閇	門 下
閈	門 干
閉	門 才
開	門 开
閌	門 亢
閍	門 方
閎	門 厷
閏	門 王
閐	門 毛
閑	門 木
閒	門 月
間	門 日
閔	門 文
閕	門 牙
閗	門 斗
閘	門 甲
閙	門 市
閛	門 平
閜	門 可
閝	門 令
閞	門 弁
閟	門 必
閠	門 玉
閡	門 亥
関	門 关
閣	門 各
閤	門 合
閥	門 伐
閦	門 众
閧	門 共
閨	門 圭
閩	門 蟲	門 虫
閫	門 困
閬	門 良
閭	門 呂
閮	門 廷
閯	門 沙
閰	門 臼
閱	門 兌
閲	門 兑
閳	門 車
閴	門 貝
閵	門 隹
閶	門 昌
閷	杀 閃
閸	門 亞
閹	門 奄
閺	門 旻
閻	門 臽
閼	門 於
閽	門 昏
閾	門 或
閿	門 受
闀	門 巷
闁	門 門
闂	門 卷
闃	門 狊
闄	門 要
闅	門 目 攴
闆	門 品
闇	門 音
闈	門 韋
闉	門 垔
闊	門 活
闋	門 癸
闌	門 柬
闍	門 者
闐	門 真
闑	門 臬
闒	門 日 羽
闓	門 豈
闔	門 盍
闕	門 欮
闖	門 馬
闗	門 絲
闘	門 豆 寸
闙	門 啟
闚	門 規
闛	門 堂
關	門 幺 幺 丱	門 幺 幺 卯
闝	門 敗
闞	門 敢
闟	門 翕
闠	門 貴
闡	門 單
闢	門 辟
闣	門 當
闤	門 睘
闥	門 達
闦	門 豊
阞	阜 力	阝 力
阠	阜 卂	阝 卂
阡	阜 千	阝 千
阢	阜 兀	阝 兀
阣	阜 乞	阝 乞
阤	阜 也	阝 也
阥	阜 水	阝 水
阦	阜 火	阝 火
阧	阜 斗	阝 斗
阨	阜 厄	阝 厄
阩	阜 升	阝 升
阪	阜 反	阝 反
阫	阜 不	阝 不
阬	阜 亢	阝 亢
阭	阜 允	阝 允
阮	阜 元	阝 元
阯	阜 止	阝 止
阰	阜 比	阝 比
阱	阜 井	阝 井
防	阜 方	阝 方
阷	阜 正	阝 正
阸	阜 戹	阝 戹
阹	阜 去	阝 去
阺	阜 氐	阝 氐
阻	阜 且	阝 且
阼	阜 乍	阝 乍
阽	阜 占	阝 占
阾	阜 令	阝 令
阿	阜 可	阝 可
陀	阜 它	阝 它
陁	阜 丿 一 也	阝 丿 一 也
陂	阜 皮	阝 皮
陃	阜 丙	阝 丙
附	阜 付	阝 付
陊	阜 多	阝 多
陋	阜 丨 一 丙	阝 丨 一 丙	阜 𠃊 丙	阝 𠃊 丙
陌	阜 百	阝 百
降	阜 夅	阝 夅
陎	阜 朱	阝 朱
陏	阜 有	阝 有
限	阜 艮	阝 艮
陑	阜 而	阝 而
陒	阜 危	阝 危
陓	阜 夸	阝 夸
陔	阜 亥	阝 亥
陖	阜 夋	阝 夋
陗	阜 肖	阝 肖
陘	阜 巠	阝 巠
陙	阜 辰	阝 辰
陚	阜 武	阝 武
陛	阜 坒	阝 坒	阜 比 土	阝 比 土
陜	阜 夾	阝 夾
陝	阜 大 入 入	阝 大 入 入
陞	阜 升 土	阝 升 土
陟	阜 步	阝 步
陠	阜 甫	阝 甫
陡	阜 走	阝 走
院	阜 完	阝 完
陣	阜 車	阝 車
除	阜 余	阝 余
陥	阜 刀 旧	阝 刀 旧
陧	阜 圼	阝 圼
陪	阜 咅	阝 咅
陫	阜 非	阝 非
陬	阜 取	阝 取
陭	阜 奇	阝 奇
陮	阜 隹	阝 隹
陯	阜 侖	阝 侖
陰	阜 侌	阝 侌
陱	阜 匊	阝 匊
陲	阜 垂	阝 垂
陳	阜 東	阝 東
陴	阜 卑	阝 卑
陵	阜 夌	阝 夌
陶	阜 匋	阝 匋
陷	阜 臽	阝 臽
陸	阜 坴	阝 坴
険	阜 人 一 口 人	阝 人 一 口 人
陻	阜 垔	阝 垔
陼	阜 者	阝 者
陽	阜 昜	阝 昜
陾	阜 耎	阝 耎
陿	阜 匧	阝 匧
隀	阜 重	阝 重
隁	阜 匽	阝 匽
隂	阜 人 镸	阝 人 镸
隃	阜 俞	阝 俞
隄	阜 是	阝 是
隅	阜 禺	阝 禺
隆	阜 夂 生	阝 夂 生	阜 夕 生	阝 夕 生
隇	阜 威	阝 威
隈	阜 畏	阝 畏
隉	阜 臼 土	阝 臼 土
隊	阜 丷 豕	阝 丷 豕
隋	阜 左 月	阝 左 月
隌	阜 音	阝 音
隍	阜 皇	阝 皇
階	阜 皆	阝 皆
隑	阜 豈	阝 豈
隒	阜 兼	阝 兼
隓	阜 左 左	阝 左 左
隔	阜 鬲	阝 鬲
隕	阜 員	阝 員
隖	阜 烏	阝 烏
隗	阜 鬼	阝 鬼
隘	阜 益	阝 益
隙	阜 小 日 小	阝 小 日 小
隚	阜 堂	阝 堂
際	阜 祭	阝 祭
障	阜 章	阝 章
隝	阜 島	阝 島
隞	阜 敖	阝 敖
隟	阜 巢	阝 巢
隠	阜 爪 彐 心	阝 爫 彐 心
隢	阜 堯	阝 堯
隣	阜 粦	阝 粦
隤	阜 貴	阝 貴
隥	阜 登	阝 登
隦	阜 辟	阝 辟
隧	阜 遂	阝 遂
隨	阜 遀	阝 遀	阜 辵 左 月
隩	阜 奧	阝 奧
險	阜 僉	阝 僉
隫	阜 賁	阝 賁
隬	阜 爾	阝 爾
隭	阜 需	阝 需
隮	阜 齊	阝 齊
隯	阜 壽	阝 壽
隰	阜 日 幺 幺 火	阝 日 幺 幺 灬	阜 㬎	阝 㬎
隱	阜 爪 工 彐 心	阝 爫 工 彐 心	阜 㥯	阝 㥯
隲	阜 少 馬	阝 少 馬
隳	阜 隋 人 心	阝 隋 人 心	阜 隋 人 小 丶	阝 隋 人 小 丶
隴	阜 龍	阝 龍
隵	阜 戲	阝 戲
隸	木 示 隶
隹	人 主 一
隺	冖 隹
隻	隹 又
隼	隹 十
隽	隹 乃
隿	弋 隹
雀	少 隹
雁	厂 人 隹	厂 亻 隹	厂 倠
雂	今 隹
雃	开 隹
雄	厷 隹
雅	牙 隹
集	隹 木
雇	户 隹
雈	草 隹	艸 隹	艹 隹
雉	矢 隹
雊	句 隹
雋	隹 丨 ㇆ 一 丨 ㇆
雌	此 隹
雍	亠 乡 隹
雎	且 隹
雐	虎 隹	虍 隹
雑	杂 隹
雒	各 隹
雓	余 隹
雔	隹 隹
雕	周 隹
雖	虽 隹
雗	十 日 十 丿 一 隹
雘	丹 蒦
雙	隹 隹 又
雚	草 口 口 隹	艸 口 口 隹	艹 口 口 隹
雛	芻 隹
雜	卒 八 隹
雝	邕 隹
雞	奚 隹
雟	屮 隹 冏
雡	翏 隹
離	离 隹
難	革 大 隹
雤	臼 爻 冖 隹	𦥯 隹
雥	隹 隹 隹
雦	隹 隹 隹
雧	集 集 集 木
雨	一 冂 丨 丶 丶 丶 丶
雩	雨 亏
雪	雨 彐
雫	雨 下
雬	雨 木
雭	雨 及
雮	雨 毛
雯	雨 文
雰	雨 分
雱	雨 方
雲	雨 云
雴	雨 立
雵	雨 央
零	雨 令
雷	雨 田
雸	雨 甘
雹	雨 包
雺	雨 矛
電	雨 电
雼	雨 石
雽	雨 乎
雿	雨 兆
需	雨 而
霂	雨 沐
霃	雨 沈
霄	雨 肖
霅	雨 言
霆	雨 廷
震	雨 辰
霈	雨 沛
霉	雨 母
霊	雨 一 亚
霋	雨 妻
霌	雨 周
霍	雨 隹
霎	雨 妾
霏	雨 非
霐	雨 泓
霑	雨 沾
霒	雲 今
霓	雨 兒
霔	雨 注
霕	雲 屯
霖	雨 林
霘	雨 洞
霙	雨 英
霚	雨 敄
霛	雨 弓 弓 弓
霜	雨 相
霝	雨 口 口 口
霞	雨 叚
霟	雨 洪
霠	雨 立 今
霢	雨 脈
霣	雨 員
霤	雨 留
霥	雨 冡
霦	雨 彬
霧	雨 務
霨	雨 尉
霩	雨 郭
霪	雨 水 爪 壬	雨 氵 爫 壬
霫	雨 習
霬	雨 異
霮	雨 湛
霯	雨 登
霰	雨 散
霱	雨 矞
露	雨 路
霳	雨 隆
霴	雲 隶
霵	雨 戢
霶	雨 滂
霷	雨 晹
霸	雨 革 月
霹	雨 辟
霺	雨 微
霼	雲 氣
霽	雨 齊
霾	雨 貍
霿	雨 敄 目
靀	雨 蒙
靁	雨 畾
靂	雨 歷
靃	雨 雔	雨 隹 隹
靄	雨 謁
靅	雲 費
靆	雲 逮
靇	雨 龍
靈	霝 巫
靉	雲 愛
靊	雨 豐
靋	雨 瀝
靌	雨 寶
靎	雨 鵭
靏	雨 鶴
靐	雷 雷 雷
靑	丰 円	三 丨 円
青	丰 月
靕	正 青
靖	立 青
靗	青 光
靘	青 色
靚	青 見
靛	青 定
靜	青 爭
靝	青 氣
非	三 丿 丨 三
靟	非 毛
靠	告 非
靡	麻 非
面	一 丶 囬	一 丶 囗 丨 丨 一 一
靣	一 丶 回
靤	面 包
靦	面 見
靧	面 貴
靨	厭 面
革	廿 口 十
靪	革 丁
靫	革 叉
靬	革 干
靭	革 刃
靮	革 勺
靯	革 土
靰	革 兀
靱	革 刄
靲	革 今
靳	革 斤
靴	革 化
靵	革 丑
靶	革 巴
靷	革 引
靸	革 及
靹	革 內
靺	革 末
靻	革 且
靼	革 旦
靽	革 半
靾	革 世
靿	革 幼
鞀	革 召
鞁	革 皮
鞂	革 和
鞃	革 弘
鞄	革 包
鞅	革 央
鞇	革 因
鞈	革 合
鞉	革 兆
鞊	革 吉
鞋	革 圭
鞌	安 革
鞍	革 安
鞎	革 艮
鞏	巩 革
鞓	革 呈
鞔	革 免
鞕	革 更
鞖	革 妥
鞗	攸 革
鞘	革 肖
鞙	革 肙
鞚	革 空
鞛	革 咅
鞜	革 沓
鞝	革 尚
鞞	革 卑
鞟	革 享
鞠	革 匊	革 勹 米
鞡	革 拉
鞢	革 枼
鞣	革 柔
鞤	封 革
鞥	革 弇
鞦	革 秋
鞧	革 酋
鞨	革 曷
鞩	革 削
鞪	敄 革
鞫	革 訇
鞬	革 建
鞭	革 便
鞮	革 是
鞱	革 舀
鞲	革 冓
鞳	革 荅
鞴	革 草 厂 用	革 艸 厂 用	革 艹 厂 用
鞵	革 奚
鞶	般 革
鞷	鬲 革
鞸	革 畢
鞹	革 郭
鞻	革 婁
鞼	革 貴
鞽	革 喬
鞾	革 華
鞿	革 幾
韀	革 廌
韁	革 畺
韂	革 詹
韃	革 達
韄	革 蒦
韅	革 日 幺 幺 火	革 日 幺 幺 灬	革 㬎
韆	革 遷
韇	革 賣
韈	革 蔑
韉	革 薦
韊	革 蘭
韋	彑 口 二 丶 丨
韌	韋 刃
韍	韋 犮
韎	韋 未
韏	丷 夫 韋	𠔉 韋
韐	韋 合
韑	光 韋
韒	韋 肖
韓	十 日 十 韋
韔	韋 長
韖	韋 柔
韗	韋 軍
韘	韋 枼
韙	是 韋
韚	韋 革
韛	韋 草 厂 用	韋 艸 厂 用	韋 艹 厂 用
韜	韋 舀
韝	韋 冓
韞	韋 昷
韠	韋 畢
韡	韋 華
韢	韋 惠
韣	韋 蜀
韤	韋 蔑
韥	韋 賣
韭	非 一
韮	草 韭	艸 韭	艹 韭
韯	十 戈 韭	𢦏 韭
韰	歺 又 韭
韱	人 人 戈 韭
韲	亠 丫 刀 □ 韭
音	立 日	立 曰
韴	音 帀
韶	音 召
韷	音 出
韸	音 夆
韹	音 皇
韺	音 英
韻	音 員
韼	音 逢
韽	酓 音
韾	殸 音
響	鄉 音
頀	音 蒦
頁	一 丶 貝
頂	丁 頁
頃	匕 頁
頄	九 頁
項	工 頁
順	川 頁
頇	干 頁
須	彡 頁
頉	止 頁
頊	玉 頁	王 頁
頋	厄 頁
頌	公 頁
頍	支 頁
頎	斤 頁
頏	亢 頁
預	予 頁
頑	元 頁
頒	分 頁
頓	屯 頁
頔	由 頁
頕	占 頁
頖	半 頁
頗	皮 頁
領	令 頁
頙	正 頁
頚	圣 頁
頛	耒 頁
頜	合 頁
頝	交 頁
頞	安 頁
頟	各 頁
頠	危 頁
頡	吉 頁
頢	舌 頁
頣	臣 頁
頤	匸 丨 口 丨 頁
頥	丨 頣
頦	亥 頁
頧	戶 乛 一 頁
頨	羽 頁
頩	并 頁	幷 頁
頪	米 頁
頫	兆 頁
頬	夹 頁
頭	豆 頁
頮	水 廾 頁
頯	月 廾 頁
頰	夾 頁
頱	寽 頁
頲	廷 頁
頳	赤 頁
頴	匕 示 頁
頵	君 頁
頶	告 頁
頷	含 頁
頸	巠 頁
頹	禿 頁
頺	秀 頁
頻	步 頁
頼	束 頁
頽	秃 頁
頾	須 此
頿	彡 此 頁	須 此
顀	隹 頁
顁	定 頁
顂	來 頁
顃	炎 頁
顄	函 頁
顅	肩 頁
顆	果 頁
顇	卒 頁
顈	匕 糸 頁
顉	金 頁	釒 頁
顊	阜 頁
顋	思 頁
題	是 頁
額	客 頁
顎	咢 頁
顏	彦 頁
顐	軍 頁
顑	咸 頁
顒	禺 頁
顓	耑 頁
顔	彥 頁
顕	显 頁
顖	囟 心 頁
顗	豈 頁
願	原 頁
顙	桑 頁
顚	眞 頁
顛	真 頁
顜	冓 頁
顝	骨 頁
類	类 頁
顟	翏 頁
顠	票 頁
顡	豙 頁
顢	廿 冂 丨 入 入 頁	㒼 頁
顣	戚 頁
顤	堯 頁
顥	景 頁
顦	焦 頁
顧	雇 頁
顨	頁 頁 丌
顩	僉 頁
顪	歲 頁
顫	亶 頁
顬	需 頁
顭	夢 頁
顮	賓 頁
顯	日 幺 幺 火 頁	日 幺 幺 灬 頁	㬎 頁
顰	頻 卑
顱	盧 頁
顲	炎 亠 回 頁
顳	聶 頁
顴	雚 頁
風	几 一 蟲	几 一 虫
颩	風 彡
颫	風 夫
颬	風 牙
颭	風 占
颮	風 包
颯	立 風
颰	風 犮
颱	風 台
颲	風 列
颳	風 舌
颴	風 丿 一 疋
颵	風 肖
颶	風 具
颷	風 炎
颸	風 思
颹	風 韋
颺	風 昜
颻	月 缶 風	䍃 風
颼	風 叟
颽	豈 風
颾	風 蚤
颿	馬 風
飀	風 留
飁	習 風
飂	風 翏
飃	風 票
飄	票 風
飅	風 畱
飆	猋 風	犬 犬 犬 風
飇	風 猋
飈	風 焱
飉	風 尞
飋	風 瑟
飌	雚 風
飛	飞 升 飞
飜	番 飛
食	人 良
飠	人 良
飡	冰 食	冫 食
飢	食 几	飠 几
飣	食 丁
飤	食 人
飥	食 乇
飦	食 干
飧	夕 食
飩	食 屯	飠 屯
飪	食 壬	飠 壬
飫	食 夭
飬	丷 夫 良	𠔉 良
飭	食 丿 一 力
飮	食 欠
飯	食 反	飠 反
飰	食 卞
飱	歹 食
飲	食 欠	飠 欠
飳	食 主
飴	食 台	飠 台
飵	食 乍
飶	食 必
飷	食 且
飸	号 食
飹	食 卯
飺	此 食
飻	食 人 彡
飼	食 司	飠 司
飽	食 包	飠 包
飾	食 丿 一 巾	飠 丿 一 巾	食 布
飿	食 出
餀	食 艾
餁	食 任
餂	食 舌
餃	食 交	飠 交
餄	食 合	飠 合
餅	食 并	飠 并	食 幷	飠 幷
餆	食 兆
餇	食 同
餈	次 食
餉	食 向	飠 向
養	羊 食
餋	丷 夫 食	𠔉 食
餌	食 耳	飠 耳
餎	食 各	飠 各
餏	食 衣
餐	歹 又 食	歺 又 食
餑	食 孛
餒	食 妥	飠 妥
餓	食 我	飠 我
餔	食 甫
餕	食 夋
餖	食 豆
餗	食 束
餘	食 余	飠 余
餘	食 余
餙	食 希
餚	食 肴	飠 肴
餛	食 昆	飠 昆
餜	食 果
餝	食 芳
餞	食 戔	飠 戔
餟	食 叕
餠	食 幷	飠 幷	食 并	飠 并
餡	食 臽	飠 臽
餢	食 咅
餣	食 奄
餤	食 炎
餥	非 食
餦	食 長
餧	食 委
館	食 官	飠 官
餩	食 八 亥
餪	食 耎
餫	食 軍
餬	食 胡	飠 胡
餭	食 皇
餮	殄 食
餯	食 彖
餰	食 衍
餱	食 侯
餲	食 曷
餳	食 昜
餴	食 奔
餵	食 畏	飠 畏
餶	食 骨
餷	食 查
餸	食 送	飠 送
餹	食 唐
餺	食 尃
餻	食 羔
餼	食 氣	飠 氣
餽	食 鬼
餾	食 留	飠 留
餿	食 叟	飠 叟
饀	食 舀
饁	食 盍
饂	食 昷
饃	食 莫	飠 莫
饄	食 堂
饅	食 曼	飠 曼
饆	食 畢
饇	食 區
饈	食 羞
饉	食 堇
饊	食 散
饋	食 貴	飠 貴
饌	食 巽	飠 巽
饍	食 善
饎	食 喜
饏	敢 食
饐	食 壹
饑	食 幾
饒	食 堯	飠 堯
饓	食 棠
饔	雍 食
饕	號 食
饖	食 歲
饗	鄉 食
饘	食 亶
饙	食 賁
饚	食 蓋
饛	食 蒙
饜	厭 食
饝	食 磨
饞	食 毚	飠 毚
饟	食 襄
饠	食 羅
饡	食 贊
饢	食 囊
首	丷 一 丶 目
馗	九 首
馘	首 或
香	禾 日
馚	香 分
馛	香 犮
馜	香 尼
馝	香 必
馞	香 孛
馟	香 孚
馠	香 含
馡	香 非
馢	香 戔
馣	香 奄
馤	香 曷
馥	香 复
馦	香 兼
馧	香 昷
馨	声 殳 香	殸 香
馩	香 賁
馪	香 賓
馫	香 香 香
馭	馬 又
馮	冰 馬	冫 馬
馯	馬 干
馰	馬 勺
馱	馬 大
馲	馬 乇
馳	馬 也
馴	馬 川
馵	馬 廾
馶	馬 支
馷	馬 巿
馸	馬 斤
馹	馬 日
馺	馬 及
馻	馬 允
馼	馬 文
馽	馬 中
馾	馬 冘
馿	馬 戶
駀	馬 尤
駁	馬 爻
駂	馬 匕 十	馬 𠤏
駃	馬 夬
駄	馬 太
駅	馬 尺
駆	馬 区
駈	馬 丘
駉	馬 冋
駊	馬 皮
駋	馬 召
駌	夗 馬
駍	馬 平
駎	馬 由
駏	馬 巨
駐	馬 主
駑	奴 馬
駒	馬 句
駓	馬 丕
駔	馬 且
駕	加 馬
駖	馬 令
駗	馬 人 彡
駘	馬 台
駙	馬 付
駚	馬 央
駛	馬 史
駜	馬 必
駝	馬 它
駞	馬 丿 一 也
駟	馬 四
駠	馬 卯
駡	口 口 馬
駢	馬 并	馬 幷
駣	馬 兆
駤	馬 至
駥	馬 戎
駦	丷 夫 馬	𠔉 馬
駧	馬 同
駨	馬 旬
駩	馬 全
駪	馬 先
駫	馬 光
駬	馬 耳
駭	馬 亥
駮	馬 交
駰	馬 因
駱	馬 各
駳	馬 延
駴	馬 戒
駵	馬 丣
駶	馬 局
駷	馬 束
駸	馬 彐 冖 又
駹	馬 尨
駺	馬 良
駻	馬 旱
駼	馬 余
駽	馬 肙
駾	馬 兌
駿	馬 夋
騀	馬 我
騁	馬 甹	馬 由 丂
騂	馬 辛
騃	馬 矣
騄	馬 彔
騅	馬 隹
騆	馬 周
騇	馬 舍
騈	馬 幷
騉	馬 昆
騊	馬 匋
騋	馬 來
騌	馬 宗
騍	馬 果
騎	馬 奇
騏	馬 其
騐	馬 念
騒	馬 又 蟲	馬 又 虫
験	馬 人 一 口 人
騔	馬 曷
騕	馬 要
騖	敄 馬
騗	扁 馬
騘	馬 怱
騙	馬 扁
騚	馬 前
騜	馬 皇
騝	馬 建
騞	馬 砉
騟	馬 俞
騠	馬 是
騡	馬 泉
騢	馬 叚
騣	馬 凶 八 夕	馬 凶 八 夂
騤	馬 癸
騥	馬 柔
騦	馬 思
騧	馬 咼
騨	馬 单 丶
騩	馬 鬼
騪	馬 叟
騫	馬 宀 井 大
騬	馬 乘
騭	陟 馬
騮	馬 留
騯	馬 旁
騰	肉 駦	月 駦
騱	馬 奚
騲	馬 草
騴	馬 妟
騵	馬 原
騶	馬 芻
騷	馬 蚤
騸	馬 扇
騹	馬 堇
騺	執 馬
騻	馬 爽
騼	馬 鹿
騽	馬 習
騾	馬 累
騿	馬 章
驀	莫 馬
驁	敖 馬
驂	馬 參
驃	馬 票
驄	馬 悤
驅	馬 區
驆	馬 畢
驇	埶 馬
驈	馬 矞
驉	馬 虛
驊	馬 華
驋	馬 發
驌	馬 肅
驍	馬 堯
驎	馬 粦
驏	馬 孱
驐	馬 敦
驑	馬 畱
驒	馬 單
驓	馬 曾
驔	馬 覃
驕	馬 喬
驖	馬 哉 王
驗	馬 僉
驘	亡 口 月 馬 凡
驙	馬 亶
驚	馬 敬
驛	馬 睪
驜	馬 業
驝	馬 槖
驞	馬 賓
驟	馬 聚
驠	馬 燕
驡	龍 馬
驢	馬 盧
驣	馬 駦
驤	馬 襄
驥	馬 冀
驦	馬 霜
驧	馬 鞠
驨	馬 巂
驩	馬 雚
驪	馬 麗
驫	馬 馬 馬
骩	骨 九
骪	骨 凡
骫	骨 丸
骬	骨 于
骭	骨 干
骮	骨 戈
骯	骨 亢
骰	骨 殳
骱	骨 介
骲	骨 包
骳	骨 皮
骴	骨 此
骵	骨 本
骶	骨 氐
骷	骨 古
骸	骨 亥
骹	骨 交
骺	骨 后
骻	骨 夸
骼	骨 各
骽	骨 妥
骾	骨 更
骿	骨 并	骨 幷
髀	骨 卑
髁	骨 果
髂	骨 客
髃	骨 禺
髄	骨 迶
髆	骨 尃
髇	骨 高
髈	骨 旁
髉	骨 隺
髊	骨 差
髍	骨 麻
髎	骨 翏
髏	骨 婁
髐	骨 堯
髑	骨 蜀
髒	骨 葬
髓	骨 遀
體	骨 豊
髕	骨 賓
髖	骨 寬
髗	骨 盧
高	亠 口 冂 口
髙	亠 丨 一 一 丨 冋
髚	高 亢
髛	高 尻
髜	高 昇
髝	高 勞
髞	高 喿
髟	镸 彡
髠	髟 几
髡	髟 兀
髢	髟 也
髣	髟 方
髤	髟 木
髥	髟 冄
髦	髟 毛
髧	髟 冘
髨	髟 元
髩	髟 丏
髪	髟 友
髫	髟 召
髬	髟 丕
髭	髟 此
髮	髟 犮
髯	髟 冉
髰	髟 髟 世
髱	髟 包
髲	髟 皮
髳	髟 矛
髴	髟 弗
髵	髟 而
髶	髟 耳
髷	髟 曲
髹	髟 休
髺	髟 舌
髻	髟 吉
髼	髟 夆
髽	髟 坐
髾	髟 肖
髿	髟 沙
鬀	髟 弟
鬁	髟 利
鬂	髟 兵
鬃	髟 宗
鬄	髟 易
鬅	髟 朋
鬆	髟 松
鬇	髟 争
鬈	髟 卷
鬉	髟 凶 八 夕	髟 凶 八 夂
鬊	髟 春
鬋	髟 前
鬌	髟 左 月
鬍	髟 胡
鬎	髟 剌
鬏	髟 秋
鬐	髟 耆
鬑	髟 廉
鬒	髟 真
鬔	髟 逢
鬕	髟 莫
鬖	髟 參
鬗	髟 廿 冂 丨 入 入	髟 㒼
鬘	髟 曼
鬙	髟 曾
鬚	髟 须
鬛	髟 囗 乂 𠄌 丶 丶 𠄌 丶 丶 乀
鬜	髟 閒
鬝	髟 間
鬞	髟 農
鬟	髟 睘
鬠	髟 會
鬡	髟 寧
鬢	髟 賓
鬣	髟 巤
鬤	髟 襄
鬥	丨 王 王 亅
鬦	鬥 斗
鬧	鬥 市
鬨	鬥 共
鬩	鬥 兒
鬪	鬥 豆 寸
鬫	鬥 敢
鬬	鬥 斵
鬭	鬥 斲
鬮	鬥 龜
鬯	凵 乂 丶 丶 丶 丶 匕
鬰	棥 冖 鬯 彡
鬱	木 缶 木 冖 鬯 彡
鬲	一 口 冂 丫 一
鬳	虎 鬲	虍 鬲
鬴	鬲 甫
鬵	旡 旡 鬲
鬷	鬲 凶 八 夕	鬲 凶 八 夂
鬸	鬲 留
鬹	規 鬲
鬺	鬲 丿 一 昜
鬻	粥 鬲
鬼	丶 田 儿 厶
鬽	鬼 彡
鬾	鬼 支
鬿	鬼 斤
魀	鬼 介
魁	鬼 斗
魂	云 鬼
魃	鬼 犮
魄	白 鬼
魅	鬼 未
魆	鬼 戉
魈	鬼 肖
魊	鬼 或
魋	鬼 隹
魌	鬼 其
魍	鬼 罔
魎	鬼 兩
魏	委 鬼
魐	鬼 兼
魑	鬼 离
魒	鬼 票
魓	鬼 畢
魔	麻 鬼
魕	鬼 幾
魖	鬼 虛
魗	鬼 壽
魘	厭 鬼
魙	鬼 漸
魚	刀 田 火	刀 田 灬
魛	魚 刀
魜	魚 人
魝	魚 刀	魚 刂
魟	魚 工
魠	魚 乇
魡	魚 勺
魢	魚 己
魣	魚 予
魤	魚 化
魥	魚 及
魦	魚 少
魧	魚 亢
魨	魚 屯
魩	魚 勿
魪	魚 介
魫	魚 冘
魬	魚 反
魭	魚 元
魮	魚 比
魯	魚 日
魰	魚 文
魱	魚 互
魲	魚 戶
魳	魚 帀
魴	魚 方
魵	魚 分
魶	魚 內
魷	魚 尤
魺	魚 可
魻	魚 甲
魼	魚 去
魽	魚 甘
魾	魚 丕
魿	魚 令
鮀	魚 它
鮁	魚 犮
鮂	魚 囚
鮃	魚 平
鮄	魚 弗
鮅	魚 必
鮆	此 魚
鮇	魚 未
鮈	魚 句
鮉	魚 召
鮊	魚 白
鮋	魚 由
鮌	魚 玄
鮍	魚 皮
鮎	魚 占
鮏	魚 生
鮐	魚 台
鮑	魚 包
鮒	魚 付
鮓	魚 乍
鮔	魚 巨
鮕	魚 古
鮙	魚 羽
鮚	魚 吉
鮛	魚 尗
鮜	魚 后
鮝	丷 夫 魚	𠔉 魚
鮞	魚 而
鮟	魚 安
鮠	魚 危
鮡	魚 兆
鮢	魚 朱
鮣	魚 印
鮤	列 魚
鮥	魚 各
鮦	魚 同
鮧	魚 夷
鮨	魚 旨
鮩	魚 并	魚 幷
鮪	魚 有
鮫	魚 交
鮬	魚 夸
鮭	魚 圭
鮮	魚 羊
鮯	魚 合
鮰	魚 回
鮳	魚 考
鮵	魚 兌
鮶	魚 君
鮷	魚 弟
鮸	魚 免
鮹	魚 肖
鮺	羊 魚
鮻	魚 夋
鮼	魚 彐 冖 又
鮽	魚 余
鮾	魚 妥
鮿	魚 耴
鯀	魚 系
鯁	魚 更
鯃	魚 吾
鯄	魚 求
鯅	魚 延
鯆	魚 甫
鯇	魚 完
鯈	攸 魚
鯉	魚 里
鯊	沙 魚
鯋	魚 沙
鯌	魚 告
鯍	魚 亠 厶 川	魚 巟	魚 㐬
鯒	魚 甬
鯓	魚 身
鯔	魚 甾
鯕	魚 其
鯖	魚 青
鯗	羊 八 魚
鯘	魚 委
鯙	魚 享
鯚	魚 季
鯛	魚 周
鯜	魚 妾
鯝	魚 固
鯞	魚 帚
鯟	魚 東
鯠	魚 來
鯡	魚 非
鯢	魚 兒
鯣	魚 易
鯤	魚 昆
鯥	魚 坴
鯦	魚 咎
鯧	魚 昌
鯨	魚 京
鯩	魚 侖
鯪	魚 夌
鯫	魚 取
鯬	禾 勹 丿 魚
鯭	魚 孟
鯮	魚 宗
鯯	魚 制
鯰	魚 念
鯴	魚 虱
鯵	魚 參
鯶	魚 軍
鯷	魚 是
鯸	魚 侯
鯹	魚 星
鯺	魚 者
鯻	魚 剌
鯼	魚 凶 八 夕	魚 凶 八 夂
鯽	魚 即
鯾	魚 便
鯿	魚 扁
鰀	魚 爰
鰁	魚 泉
鰂	魚 則
鰃	魚 畏
鰄	魚 威
鰅	魚 禺
鰆	魚 春
鰇	魚 柔
鰈	魚 枼
鰉	魚 皇
鰊	魚 柬
鰋	魚 匽
鰌	魚 酋
鰍	魚 秋
鰎	魚 建
鰏	魚 畐
鰐	魚 咢
鰑	魚 昜
鰒	魚 复
鰓	魚 思
鰔	魚 咸
鰕	魚 叚
鰖	魚 左 月
鰗	魚 胡
鰙	魚 若
鰛	魚 昷
鰜	魚 兼
鰝	魚 高
鰞	魚 烏
鰟	魚 旁
鰠	魚 蚤
鰡	魚 留
鰢	魚 馬
鰣	魚 時
鰤	魚 師
鰥	魚 眔
鰧	肉 鮝	月 鮝
鰨	魚 日 羽
鰩	魚 月 缶	魚 䍃
鰪	魚 盍
鰫	魚 容
鰬	魚 虔
鰭	魚 耆
鰮	魚 昷
鰯	魚 弱
鰱	魚 連
鰲	敖 魚
鰳	魚 勒
鰴	彳 山 一 魚 攴	彳 山 一 魚 攵
鰵	敏 魚
鰶	魚 祭
鰷	魚 條
鰸	魚 區
鰹	魚 堅
鰺	魚 參
鰻	魚 曼
鰼	魚 習
鰽	魚 曹
鰾	魚 票
鰿	魚 責
鱀	既 魚
鱁	魚 逐
鱂	魚 將
鱃	魚 羞
鱄	魚 專
鱅	魚 庸
鱆	魚 章
鱇	魚 康
鱈	魚 雪
鱉	魚 敝
鱊	魚 矞
鱋	魚 虛
鱌	魚 象
鱍	魚 發
鱎	魚 喬
鱏	魚 覃
鱐	魚 肅
鱑	魚 黃
鱒	魚 尊
鱓	魚 單
鱔	魚 善
鱕	魚 番
鱖	魚 厥
鱗	魚 粦
鱘	魚 尋
鱙	魚 堯
鱚	魚 喜
鱝	魚 賁
鱞	魚 睘
鱟	臼 爻 冖 魚	𦥯 魚
鱠	魚 會
鱡	魚 賊
鱢	魚 喿
鱣	魚 亶
鱤	魚 感
鱥	魚 歲
鱦	魚 黽
鱧	魚 豊
鱨	魚 嘗
鱬	魚 需
鱭	魚 齊
鱮	魚 與
鱯	魚 蒦
鱱	魚 厲
鱲	魚 巤
鱳	魚 樂
鱴	魚 蔑
鱵	魚 箴
鱶	魚 養
鱷	魚 噩
鱸	魚 盧
鱹	魚 雚
鱺	魚 麗
鱻	魚 魚 魚
鳥	户 一 一 ㇆ 火	户 一 一 ㇆ 灬
鳦	鳥 乙
鳧	鳥 几
鳨	鳥 力
鳩	九 鳥
鳪	卜 鳥
鳫	厂 鳥
鳬	户 一 一 ㇆ 几
鳭	刀 鳥
鳮	又 鳥
鳯	几 鳥
鳱	干 鳥
鳲	尸 鳥
鳳	几 一 鳥
鳴	口 鳥
鳵	卂 鳥
鳶	弋 鳥
鳷	支 鳥
鳸	戶 鳥
鳹	今 鳥
鳺	夫 鳥
鳻	分 鳥
鳼	文 鳥
鳽	开 鳥
鳾	帀 鳥
鳿	玉 鳥	王 鳥
鴀	不 鳥
鴁	夭 鳥
鴂	夬 鳥
鴃	鳥 夬
鴄	匹 鳥
鴅	丹 鳥
鴆	冘 鳥
鴇	匕 十 鳥	𠤏 鳥
鴈	厂 人 鳥	厂 亻 鳥
鴉	牙 鳥
鴊	正 鳥
鴋	方 鳥
鴌	天 鳥
鴍	文 鳥
鴎	区 鳥
鴏	鳥 代
鴐	加 鳥
鴑	奴 鳥
鴒	令 鳥
鴓	必 鳥
鴔	乏 鳥
鴕	鳥 它
鴖	民 鳥
鴗	立 鳥
鴘	弁 鳥
鴙	矢 鳥
鴚	鳥 可
鴛	夗 鳥
鴜	此 鳥
鴝	句 鳥
鴞	号 鳥
鴟	氐 鳥
鴠	旦 鳥
鴡	且 鳥
鴢	幼 鳥
鴣	古 鳥
鴤	鳥 冬
鴥	鳥 穴
鴦	央 鳥
鴧	宂 鳥
鴨	甲 鳥
鴩	失 鳥
鴪	穴 鳥
鴬	小 冖 鳥
鴭	戶 乛 一 鳥	户 乛 一 鳥
鴮	烏 鳥
鴯	而 鳥
鴰	舌 鳥
鴱	艾 鳥
鴲	旨 鳥
鴳	安 鳥
鴴	行 鳥
鴵	兆 鳥
鴶	吉 鳥
鴷	列 鳥
鴸	朱 鳥
鴹	羊 鳥
鴺	夷 鳥
鴻	水 工 鳥	氵 工 鳥
鴼	鳥 各
鴽	如 鳥
鴾	牟 鳥
鴿	合 鳥
鵀	任 鳥
鵁	交 鳥
鵂	休 鳥
鵃	舟 鳥
鵄	至 鳥
鵅	各 鳥
鵉	亦 鳥
鵊	夾 鳥
鵋	忌 鳥
鵌	余 鳥
鵍	完 鳥
鵎	妥 鳥
鵏	甫 鳥
鵐	巫 鳥
鵑	肙 鳥
鵒	谷 鳥
鵓	孛 鳥
鵔	鳥 夋
鵕	夋 鳥
鵖	皂 鳥
鵗	希 鳥
鵘	君 鳥
鵙	貝 鳥
鵚	禿 鳥
鵛	巠 鳥
鵜	弟 鳥
鵝	我 鳥
鵞	我 鳥
鵟	狂 鳥
鵠	告 鳥
鵡	武 鳥
鵢	身 鳥
鵣	束 鳥
鵦	录 鳥
鵧	并 鳥	幷 鳥
鵨	舍 鳥
鵩	服 鳥
鵪	奄 鳥
鵫	卓 鳥
鵬	朋 鳥
鵭	金 鳥	釒 鳥
鵮	臽 鳥
鵯	卑 鳥
鵰	周 鳥
鵱	坴 鳥
鵲	昔 鳥
鵳	肩 鳥
鵴	匊 鳥
鵵	兔 鳥
鵶	亞 鳥
鵷	宛 鳥
鵸	奇 鳥
鵹	禾 勹 丿 鳥
鵺	夜 鳥
鵻	鳥 隹
鵼	空 鳥
鵽	叕 鳥
鵾	昆 鳥
鵿	鳥 昇
鶀	鳥 其
鶁	京 鳥
鶂	兒 鳥
鶃	鳥 兒
鶄	青 鳥
鶅	甾 鳥
鶆	來 鳥
鶇	東 鳥
鶈	妻 鳥
鶉	享 鳥
鶊	庚 鳥
鶋	居 鳥
鶌	屈 鳥
鶏	爪 夫 鳥	爫 夫 鳥
鶐	述 鳥
鶒	勅 鳥
鶓	苗 鳥
鶔	柔 鳥
鶕	音 鳥
鶖	秋 鳥
鶗	是 鳥
鶘	胡 鳥
鶙	帝 鳥
鶚	咢 鳥
鶛	皆 鳥
鶜	茅 鳥
鶝	畐 鳥
鶞	盾 鳥
鶟	突 鳥
鶠	匽 鳥
鶡	曷 鳥
鶢	爰 鳥
鶣	扁 鳥
鶤	軍 鳥
鶥	眉 鳥
鶦	胡 鳥
鶧	英 鳥
鶨	彖 鳥
鶩	敄 鳥
鶪	狊 鳥
鶬	倉 鳥
鶭	紡 鳥
鶮	高 鳥
鶯	火 火 冖 鳥	𤇾 鳥
鶰	員 鳥
鶱	宀 井 大 鳥
鶲	翁 鳥
鶳	鳥 師
鶴	隺 鳥
鶵	芻 鳥
鶶	唐 鳥
鶷	害 鳥
鶸	弱 鳥
鶹	留 鳥
鶺	脊 鳥
鶻	骨 鳥
鶼	兼 鳥
鶽	隼 鳥
鶾	十 日 十 丿 一 鳥
鶿	兹 鳥
鷀	兹 鳥
鷁	益 鳥
鷂	爪 缶 鳥	爫 缶 鳥
鷃	妟 鳥
鷄	奚 鳥
鷅	栗 鳥
鷆	眞 鳥
鷇	士 冖 一 鳥 殳
鷈	鳥 虒
鷉	虒 鳥
鷊	鬲 鳥
鷋	荼 鳥
鷌	鳥 馬
鷍	臬 鳥
鷎	皋 鳥
鷏	真 鳥
鷐	晨 鳥
鷑	笠 鳥
鷒	專 鳥
鷓	庶 鳥
鷔	敖 鳥
鷕	唯 鳥
鷖	殹 鳥
鷗	區 鳥
鷘	敕 鳥
鷙	執 鳥
鷚	翏 鳥
鷛	庸 鳥
鷜	婁 鳥
鷝	畢 鳥
鷞	爽 鳥
鷟	族 鳥
鷠	魚 鳥
鷡	無 烏
鷢	厥 鳥
鷣	覃 鳥
鷤	單 鳥
鷥	絲 鳥
鷦	焦 鳥
鷧	壹 鳥
鷨	華 鳥
鷩	敝 鳥
鷪	目 目 冖 鳥
鷫	肅 鳥
鷬	黃 鳥
鷭	番 鳥
鷮	喬 鳥
鷯	尞 鳥
鷰	廿 北 口 鳥
鷱	臯 鳥
鷲	就 鳥
鷳	閒 鳥
鷴	閑 鳥
鷵	屠 鳥
鷶	買 鳥
鷷	尊 鳥
鷸	矞 鳥	矛 冏 鳥
鷹	广 人 隹 鳥	广 亻 隹 鳥	广 倠 鳥
鷺	路 鳥
鷻	鳥 敦
鷼	間 鳥
鷽	臼 爻 冖 鳥	𦥯 鳥
鷾	意 鳥
鷿	辟 鳥
鸀	蜀 鳥
鸁	亡 口 月 鳥 凡
鸂	水 鷄	氵 鷄
鸃	鳥 義
鸄	敫 鳥
鸅	睪 鳥
鸆	虞 鳥
鸇	亶 鳥
鸈	業 鳥
鸉	楊 鳥
鸊	辟 鳥
鸋	寧 鳥
鸌	鳥 蒦
鸍	爾 鳥
鸎	賏 鳥
鸏	蒙 鳥
鸐	翟 鳥
鸑	獄 鳥
鸒	與 鳥
鸓	畾 鳥
鸔	鳥 暴
鸕	盧 鳥
鸖	霍 鳥
鸗	龍 鳥
鸘	霜 鳥
鸙	龠 鳥
鸚	嬰 鳥
鸛	雚 鳥
鸜	瞿 鳥
鸝	麗 鳥
鸞	絲 言 鳥	糸 言 糸 鳥	䜌 鳥
鹵	卜 囗 丰
鹶	鹵 今
鹷	鹵 令
鹸	鹵 人 一 口 人
鹹	鹵 咸
鹺	鹵 差
鹻	鹵 兼
鹼	鹵 僉
鹽	臣 丿 一 鹵 皿
鹿	广 乛 一 丨 丨 比
麀	鹿 匕
麁	刀 鹿
麂	鹿 几
麃	鹿 火	鹿 灬
麄	分 鹿
麅	鹿 包
麆	鹿 且
麇	鹿 禾
麈	鹿 主
麉	干 干 鹿
麊	米 鹿
麋	鹿 米
麌	鹿 吳
麍	鹿 亠 厶 川	鹿 巟	鹿 㐬
麎	鹿 辰
麏	鹿 君
麐	鹿 吝
麑	鹿 兒
麒	鹿 其
麓	林 鹿
麔	鹿 咎
麕	鹿 囷
麖	鹿 京
麗	丽 鹿
麘	鹿 香
麙	鹿 咸
麚	鹿 叚
麛	鹿 弭
麜	鹿 栗
麝	鹿 射
麞	鹿 章
麟	鹿 粦
麠	鹿 畺
麡	鹿 齊
麢	鹿 霝
麣	鹿 嚴
麤	鹿 鹿 鹿
麥	來 夕	來 夂
麧	麥 乞
麨	麥 少
麩	麥 夫
麪	麥 丐
麫	麥 丏
麬	麥 皮
麭	麥 包
麮	麥 去
麯	麥 曲
麰	麥 牟
麱	麥 甫
麲	麥 見
麳	麥 來
麴	麥 匊	麥 勹 米
麴	麥 匊
麵	麥 面
麵	麥 面
麷	麥 豐
麻	广 林
麼	麻 幺
麽	麻 么
麾	麻 毛
黀	麻 取
黁	麻 香
黂	麻 賁
黃	廿 一 田 八
黅	黃 今
黆	黃 冘
黇	黃 占
黈	黃 主
黊	黃 圭
黋	黃 光
黌	臼 爻 冖 黃	𦥯 黃
黍	禾 人 水	秂 水
黎	黍 勹 丿	禾 勹 丿 人 水
黏	黍 占
黐	黍 离
黑	口 丷 土 火	口 丷 土 灬	里 丷 火	里 丷 灬
黒	里 火	里 灬
黓	黑 戈
黔	黑 今
黕	黑 冘
黖	黑 旡
黗	黑 屯
默	黑 犬
黙	里 犬 火	里 犬 灬
黚	黑 甘
黛	代 黑
黜	黑 出
黝	黑 幼
點	黑 占
黟	黑 多
黠	黑 吉
黢	黑 夋
黣	黑 每
黤	黑 奄
黥	黑 京
黦	黑 宛
黧	禾 勹 丿 黑
黨	尚 黑
黫	黑 垔
黬	黑 咸
黭	黑 弇
黮	黑 甚
黯	黑 音
黰	黑 真
黱	肉 丷 夫 黑	月 丷 夫 黑	肉 𠔉 黑	月 𠔉 黑
黲	黑 參
黳	殹 黑
黴	彳 山 一 黑 攴	彳 山 一 黑 攵
黵	黑 詹
黶	壓 黑
黷	黑 賣
黸	黑 盧
黹	业 八 巾 八
黺	黹 分
黻	黹 犮
黼	黹 甫
黽	冂 一
黿	元 黽
鼀	圥 黽
鼁	去 黽
鼂	旦 黽
鼃	圭 黽
鼄	朱 黽
鼅	知 黽
鼆	冥 黽
鼇	敖 黽
鼈	敝 黽
鼉	口 口 田 一 黽
鼊	辟 黽
鼎	目 爿 片
鼏	冖 鼎
鼐	乃 鼎
鼑	卜 鼎
鼒	才 鼎
鼓	十 豆 支
鼔	十 豆 攴
鼕	鼓 冬
鼖	十 艹 鼓
鼗	兆 鼓
鼘	鼓 片 一 爿
鼙	鼓 卑
鼚	鼓 長
鼛	鼓 处 口
鼜	鼓 蚤
鼝	淵 鼓
鼞	鼓 堂
鼟	鼓 登
鼠	臼 𠄌 丶 丶 𠄌 丶 丶 乀
鼡	小 用
鼢	鼠 分
鼣	鼠 犬
鼤	鼠 文
鼥	鼠 犮
鼦	鼠 召
鼧	鼠 它
鼨	鼠 冬
鼩	鼠 句
鼪	鼠 生
鼫	鼠 石
鼬	鼠 由
鼭	鼠 寺
鼮	鼠 廷
鼯	鼠 吾
鼰	鼠 貝
鼱	鼠 青
鼲	鼠 軍
鼳	鼠 狊
鼴	鼠 匽
鼵	鼠 突
鼶	鼠 虒
鼷	鼠 奚
鼸	鼠 兼
鼺	鼠 畾
鼻	自 田 廾
鼼	鼻 丩
鼽	鼻 九
鼾	鼻 干
鼿	鼻 兀
齀	鼻 瓦
齁	鼻 句
齂	鼻 隶
齃	鼻 曷
齄	鼻 查
齅	鼻 臭
齆	鼻 邕
齇	鼻 虘
齈	鼻 農
齉	鼻 囊
齊	亠 刀 丫 □ 丿 丨 二
齋	齊 小
齌	齊 火
齍	齊 皿
齎	齊 貝
齏	亠 丫 刀 □ 丿 丨 二 韭
齒	止 人 人 凵 一 人 人
齓	齒 乚
齔	齒 匕
齕	齒 乞
齖	齒 牙
齗	齒 斤
齘	齒 介
齙	齒 包
齚	齒 乍
齛	齒 世
齜	齒 此
齝	齒 台
齞	齒 只
齟	齒 且
齠	齒 召
齡	齒 令
齢	歯 令
齣	齒 句
齤	丷 夫 齒	𠔉 齒
齥	齒 曳
齦	齒 艮
齧	丰 刀 齒
齨	齒 臼
齩	齒 交
齪	齒 足
齫	齒 困
齬	齒 吾
齭	齒 所
齮	齒 奇
齯	齒 兒
齰	齒 昔
齱	齒 取
齲	齒 禹
齳	齒 軍
齴	齒 彦
齵	齒 禺
齶	齒 咢
齷	齒 屋
齸	齒 益
齹	差 齒
齺	齒 芻
齻	齒 真
齼	齒 楚
齽	齒 禁
齾	獻 齒
龍	立 月 一 𠃑 一 乚 三
龎	厂 龍
龏	龍 廾
龐	广 龍
龑	龍 天
龒	龍 示
龓	有 龍
龔	龍 共
龕	合 龍
龖	龍 龍
龗	霝 龍
龘	龍 龍 龍
龜	刀 □ 丨 乚 彐 彐 囗 乂
龝	禾 龜
龞	敝 龜
龠	人 一 口 口 口 冊
龡	龠 欠
龢	龠 禾
龣	龠 录
龤	龠 皆
龥	龠 頁
□	夾 刀	夾 刂
□	魚 巴
□	魚 尉
□	魚 管
□	睘 鳥
㧹	手 得	扌 得	才 得
㗎	口 架
䀹	目 夾
呣	口 母
嚒	口 麼
嚡	口 鞋
揤	手 即	扌 即	才 即
閪	門 西
㒓	人 達	亻 達
㓟	皮 刀	皮 刂
㓤	吉 刀	吉 刂
㕕	厶 厶
㕭	口 夭
㕸	口 立
㖠	口 奈
㖭	口 添
㗅	口 胡
㗆	口 革
㗾	口 靴
㘘	絲 言 口	糸 言 糸 口	䜌 口
㞗	尸 求
㤻	卵 心
㦴	各 戈
㧬	巩 手
㧵	手 否	扌 否	才 否
㧺	手 沓	扌 沓	才 沓
㧻	手 豖	扌 豖	才 豖
㧼	手 表	扌 表	才 表
㧽	手 固	扌 固	才 固
㧾	手 忽	扌 忽	才 忽
㧿	手 從	扌 從	才 從
㨀	手 秉	扌 秉	才 秉
㨁	手 直	扌 直	才 直
㨃	手 享	扌 享	才 享
㨄	手 周	扌 周	才 周
㨅	手 芮	扌 芮	才 芮
㨆	手 林	扌 林	才 林
㨇	波 手
㨈	手 斉	扌 斉	才 斉
㨉	手 昬	扌 昬	才 昬
㨊	手 左 肉	扌 左 肉	才 左 肉
㨋	手 者	扌 者	才 者
㨌	士 冖 手 殳
㨍	封 手
㨎	手 耎	扌 耎	才 耎
㨏	手 炭	扌 炭	才 炭
㨐	手 保	扌 保	才 保
㨒	手 奎	扌 奎	才 奎
㨓	手 罕	扌 罕	才 罕
㨔	手 咸	扌 咸	才 咸
㨕	手 盈	扌 盈	才 盈
㨗	手 疌	扌 疌	才 疌
㨘	手 省	扌 省	才 省
㨢	手 能	扌 能	才 能
㨥	手 納	扌 納	才 納
㩒	手 禁	扌 禁	才 禁
㩧	手 暴	扌 暴	才 暴
㩻	危 支
㱦	歹 奇
㹃	非 牛
㿭	斥 皮
䁪	目 斬
䂿	石 沓
䇱	竹 囗 夕
䈫	竹 納
䉭	竹 巤
䉺	米 工
䍇	缶 乏
䐙	肉 革	月 革
䖙	卧 虒	臥 虒
䘆	蟲 憲	虫 憲
䛿	言 鬲
䞘	走 乞
䟜	足 內
䟴	足 辰
䠋	足 卑
䤚	月 里
䨣	雨 革
䨩	雨 神
䪂	革 棘
䫯	旑 頁
䭔	食 追	飠 追
䭮	髟 首
䭰	香 奉
䳍	共 鳥
𠜱	卑 刀	卑 刂
𠝹	界 刀	界 刂
𠮨	口 乃
𠱃	口 凹
𠱸	口 臣
𠴕	口 妙
𠵼	口 孟
𠵿	口 披
𠶧	口 店
𠸎	口 挐
𠹳	口 桀
𠺘	口 浪
𠺝	口 格
𠺪	口 氣
𠺫	口 料
𠻹	口 添
𠼮	口 僞
𠼱	口 累
𠼻	口 基
𠽤	口 戟
𠾍	口 棄
𠾴	口 棒
𠿭	口 滑
𡁜	口 禍
𡁯	口 奪
𡁵	口 緊
𡁶	口 截
𡁻	口 趙
𡃁	口 靚
𡃴	口 隨
𡃶	口 錫
𡄽	口 瀉
𡉼	升 土
𡍚	土 林
𢃇	巾 里
𢆡	乳 年
𢝵	飛 心
𢞵	飛 必
𢠃	猄 心
𢫏	扌 冚	扌 冚	才 冚
𢫨	手 戎	扌 戎	才 戎
𢭃	手 豆	扌 豆	才 豆
𢮁	手 於	扌 於	才 於
𢮂	手 弦	扌 弦	才 弦
𢮇	手 士 母	扌 士 母	才 士 母
𢮈	手 忿	扌 忿	才 忿
𢮉	手 厂 兆	扌 厂 兆	才 厂 兆
𢮊	手 軋	扌 軋	才 軋
𢮋	手 承	扌 承	才 承
𢮍	手 穹	扌 穹	才 穹
𢮎	手 虎	扌 虎	才 虎
𢮏	手 咅
𢮐	手 尚	扌 尚	才 尚
𢮑	手 彔	扌 彔	才 彔
𢮒	手 阜	扌 阜	才 阜
𢮓	手 制	扌 制	才 制
𢮜	基 手
𢮝	取 手
𢯊	手 的	扌 的	才 的
𢯎	手 肴	扌 肴	才 肴
𢯎	手 肴	扌 肴	才 肴
𢯩	手 則	扌 則	才 則
𢯪	手 广 屰	扌 广 屰	才 广 屰
𢯫	手 段	扌 段	才 段
𢯮	手 胃	扌 胃	才 胃
𢯰	手 律	扌 律	才 律
𢯲	目 叉 手
𢯵	手 目 夬	扌 目 夬	才 目 夬
𢯶	手 室	扌 室	才 室
𢯷	手 韋	扌 韋	才 韋
𢯹	手 革	扌 革	才 革
𢯺	手 禹	扌 禹	才 禹
𢯼	手 衍	扌 衍	才 衍
𢯽	手 苴	扌 苴	才 苴
𢯾	手 冒	扌 冒	才 冒
𢯿	手 苞	扌 苞	才 苞
𢰃	手 穾	扌 穾	才 穾
𢰅	手 弜 一 八	扌 弜 一 八	才 弜 一 八
𢰆	手 苻	扌 苻	才 苻
𢰋	手 囗 而	扌 囗 而	才 囗 而
𢰌 	手 罒 心	手 网 心	扌 罒 心	扌 网 心	才 罒 心	才 网 心
𢰍	手 亠 口 火	扌 亠 口 火	才 亠 口 火
𢰏	手 孚	扌 孚	才 孚
𢰙	手 至 寸	扌 至 寸	才 至 寸
𢰝	手 茂	扌 茂	才 茂
𢰞	敃 手
𢰠	手 幽	扌 幽	才 幽
𢰡	手 侯	扌 侯	才 侯
𢰢	手 首	扌 首	才 首
𢰥	手 苔	扌 苔	才 苔
𢰦	手 春	扌 春	才 春
𢰧	手 斿	扌 斿	才 斿
𢰨	恆 手
𢰩	手 兹	扌 兹	才 兹
𢰫	手 工 兆	扌 工 兆	才 工 兆
𢰬	手 隶	扌 隶	才 隶
𢰭	手 勇	扌 勇	才 勇
𢰮	手 胡	扌 胡	才 胡
𢰯	手 枣	扌 枣	才 枣
𢰲	手 眉	扌 眉	才 眉
𢰳	手 要	扌 要	才 要
𢰴	手 故	扌 故	才 故
𢰶	扌 英	扌 英	才 英
𢰷	手 点	扌 点	才 点
𢰸	手 咼	扌 咼	才 咼
𢰹	手 約	扌 約	才 約
𢰺	手 負	扌 負	才 負
𢰻	手 臼 丨 丂	扌 臼 丨 丂	才 臼 丨 丂
𢰽	手 急	扌 急	才 急
𢰾	手 怠	扌 怠	才 怠
𢱁	手 苜	扌 苜	才 苜
𢱃	手 科	扌 科	才 科
𢱆	手 咨	扌 咨	才 咨
𢱈	手 叚	扌 叚	才 叚
𢱉	手 歪	扌 歪	才 歪
𢱋	手 度	扌 度	才 度
𢱍	手 勉	扌 勉	才 勉
𢱎	手 拜	扌 拜	才 拜
𢱏	手 訂	扌 訂	才 訂
𢱐	手 姚	扌 姚	才 姚
𢱑	手 穴 爪	扌 穴 爪	才 穴 爪
𢱒	手 美	扌 美	才 美
𢱓	手 洗	扌 洗	才 洗
𢱔	手 盆	扌 盆	才 盆
𢱕	手 耷	扌 耷	才 耷
𢱖	手 某	扌 某	才 某
𢱗	手 苦	扌 苦	才 苦
𢱘	手 彥	扌 彥	才 彥
𢱙	手 孩	扌 孩	才 孩
𢱚	手 風	扌 風	才 風
𢱛	手 洒	扌 洒	才 洒
𢱜	手 待	扌 待	才 待
𢱝	手 茁	扌 茁	才 茁
𢱞	手 茁
𢳆	手 敖	扌 敖	才 敖
𢴈	手 笪	扌 笪	才 笪
𢶤	手 靴	扌 靴	才 靴
𢷮	扌 對	扌 對	才 對
𢺋	難 手
𢺳	手 蠻	扌 蠻	才 蠻
𣖕	木 屏
𣚺	未 成 母
𣲷	氵 囗 又
𤆣	火 及
𤊓	火 兒
𤓓	火 羅
𤘅	牙 子
𤶸	疒 那
𤷈	疒 奈
𤷪	疒 孟
𤺧	疒 曾
𥄫	目 及
𥇣	目 屈
𥊼	目 牚
𥋇	目 掌
𥹉	米 囗 又
𦟌	肉 展	月 展
𦢓	肉 墨	月 墨
𦧲	舌 累
𦧺	舌 賴
𧊅	蟲 另	虫 另
𧋦	蟲 尾	虫 尾
𧕴	難 蟲	難 虫
𧘹	衤 太
𧢝	厲 見
𧥺	言 勻
𧬪	言 運
𨂾	足 南
𨃩	足 扇
𨅝	足 牚
𨆪	輕 足
𨈓	身 小
𨋢	車 立
𨳊	門 九
𨳍	門 七
𨳒	門 小
𨶙	門 能
𩓙	匕 矢 頁
𩓥	岳 頁
𩗴	風 奉
𩩍	骨 甹
𩬎	髟 壬
	口 賴
㚇	兇 夂	凶 八 夂	凶 八 夕
𡕩	囟 儿 夕	囟 儿 夂
㨑	手 㚇	扌 㚇	才 㚇
䁓	目 㚇
𥊙	目 𡕩	目 㚇
巭	功 夫
𧩙	言 廴 旦
𩶘	魚 立
